timestamp,interval_count,total_count,queue_size,max_queue_size,cpu_percent
2025-09-02T09:28:24.438625,47,47,1.0,1,0.0
2025-09-02T09:28:24.938905,134,181,1.0,1,8.8
2025-09-02T09:28:25.439175,54,235,1.0,1,6.9
2025-09-02T09:28:25.939391,55,290,1.0,1,5.7
2025-09-02T09:28:26.439611,78,368,1.0,1,6.0
2025-09-02T09:28:26.939831,54,422,1.0,1,8.1
2025-09-02T09:28:27.440035,4,426,1.0,1,4.9
2025-09-02T09:28:27.940236,25,451,1.0,1,4.7
2025-09-02T09:28:28.440505,13,464,1.0,1,6.8
2025-09-02T09:28:28.940714,4,468,1.0,1,5.0
2025-09-02T09:28:29.440901,15,483,1.0,1,5.5
2025-09-02T09:28:29.941111,56,539,1.0,1,5.0
2025-09-02T09:28:30.441338,31,570,1.0,1,8.2
2025-09-02T09:28:30.941522,31,601,1.0,1,7.1
2025-09-02T09:28:31.441724,144,745,1.0,1,7.7
2025-09-02T09:28:31.941937,0,745,1.0,1,7.5
2025-09-02T09:28:32.442156,2,747,1.0,1,4.5
2025-09-02T09:28:32.942387,1,748,1.0,1,4.0
2025-09-02T09:28:33.442687,65,813,1.0,1,5.2
2025-09-02T09:28:33.942891,28,841,1.0,1,7.9
2025-09-02T09:28:34.443125,5,846,1.0,1,5.2
2025-09-02T09:28:34.943359,5,851,1.0,1,4.9
2025-09-02T09:28:35.443716,5,856,1.0,1,4.4
2025-09-02T09:28:35.944123,2,858,1.0,1,6.7
2025-09-02T09:28:36.444352,0,858,1.0,1,4.2
2025-09-02T09:28:36.944586,4,862,1.0,1,4.3
2025-09-02T09:28:37.444812,2,864,1.0,1,4.3
2025-09-02T09:28:37.945033,0,864,1.0,1,6.5
2025-09-02T09:28:38.445271,10,874,1.0,1,5.3
2025-09-02T09:28:38.945476,1,875,1.0,1,4.3
2025-09-02T09:28:39.445702,0,875,1.0,1,4.0
2025-09-02T09:28:39.945928,0,875,1.0,1,7.2
2025-09-02T09:28:40.446156,0,875,1.0,1,5.3
2025-09-02T09:28:40.946389,0,875,1.0,1,6.5
2025-09-02T09:28:41.446638,114,989,1.0,1,11.1
2025-09-02T09:28:41.946867,1,990,1.0,1,6.4
2025-09-02T09:28:42.447139,0,990,1.0,1,4.1
2025-09-02T09:28:42.947381,0,990,1.0,1,4.0
2025-09-02T09:28:43.447626,0,990,1.0,1,5.7
2025-09-02T09:28:43.947919,0,990,1.0,1,5.7
2025-09-02T09:28:44.448143,0,990,1.0,1,4.0
2025-09-02T09:28:44.948361,0,990,1.0,1,4.4
2025-09-02T09:28:45.448660,0,990,1.0,1,6.8
2025-09-02T09:28:45.948934,38,1028,1.0,1,9.0
2025-09-02T09:28:46.449179,13,1041,1.0,1,7.2
2025-09-02T09:28:46.949622,3,1044,1.0,1,5.5
2025-09-02T09:28:47.449837,65,1109,1.0,1,9.3
2025-09-02T09:28:47.950059,0,1109,1.0,1,5.4
2025-09-02T09:28:48.450325,0,1109,1.0,1,4.8
2025-09-02T09:28:48.950568,0,1109,1.0,1,3.9
2025-09-02T09:28:49.450792,0,1109,1.0,1,6.7
2025-09-02T09:28:49.951018,0,1109,1.0,1,5.8
2025-09-02T09:28:50.451355,1,1110,1.0,1,5.9
2025-09-02T09:28:50.951668,2,1112,1.0,1,5.9
2025-09-02T09:28:51.451979,8,1120,1.0,1,4.2
2025-09-02T09:28:51.952366,2,1122,1.0,1,4.1
2025-09-02T09:28:52.452682,9,1131,1.0,1,8.1
2025-09-02T09:28:52.953021,1,1132,1.0,1,4.2
2025-09-02T09:28:53.453316,0,1132,1.0,1,4.1
2025-09-02T09:28:53.953661,0,1132,1.0,1,4.1
2025-09-02T09:28:54.453900,0,1132,1.0,1,6.0
2025-09-02T09:28:54.954128,0,1132,1.0,1,4.3
2025-09-02T09:28:55.454403,0,1132,1.0,1,4.4
2025-09-02T09:28:55.954640,0,1132,1.0,1,4.3
2025-09-02T09:28:56.454925,0,1132,1.0,1,4.8
2025-09-02T09:28:56.955176,0,1132,1.0,1,5.3
2025-09-02T09:28:57.455416,0,1132,1.0,1,4.2
2025-09-02T09:28:57.955652,0,1132,1.0,1,4.1
2025-09-02T09:28:58.455897,0,1132,1.0,1,4.0
2025-09-02T09:28:58.956134,0,1132,1.0,1,7.0
2025-09-02T09:28:59.456377,0,1132,1.0,1,4.1
2025-09-02T09:28:59.956609,0,1132,1.0,1,4.1
2025-09-02T09:29:00.456841,0,1132,1.0,1,4.2
2025-09-02T09:29:00.957067,0,1132,1.0,1,6.6
2025-09-02T09:29:01.457360,0,1132,1.0,1,3.8
2025-09-02T09:29:01.957599,0,1132,1.0,1,4.0
2025-09-02T09:29:02.457830,0,1132,1.0,1,4.5
2025-09-02T09:29:02.958049,0,1132,1.0,1,6.4
2025-09-02T09:29:03.458282,0,1132,1.0,1,3.9
2025-09-02T09:29:03.958484,0,1132,1.0,1,4.1
2025-09-02T09:29:04.458713,0,1132,1.0,1,4.0
2025-09-02T09:29:04.958952,0,1132,1.0,1,6.7
2025-09-02T09:29:05.459189,0,1132,1.0,1,4.9
2025-09-02T09:29:05.959431,0,1132,1.0,1,4.4
2025-09-02T09:29:06.459664,0,1132,1.0,1,4.0
2025-09-02T09:29:06.959883,0,1132,1.0,1,6.6
2025-09-02T09:29:07.460116,0,1132,1.0,1,4.6
2025-09-02T09:29:07.960355,0,1132,1.0,1,4.0
2025-09-02T09:29:08.460575,0,1132,1.0,1,4.1
2025-09-02T09:29:08.960802,0,1132,1.0,1,6.4
2025-09-02T09:29:09.461046,0,1132,1.0,1,4.2
2025-09-02T09:29:09.961279,0,1132,1.0,1,3.8
2025-09-02T09:29:10.461488,0,1132,1.0,1,4.5
2025-09-02T09:29:10.961716,0,1132,1.0,1,4.4
2025-09-02T09:29:11.461936,0,1132,1.0,1,6.5
2025-09-02T09:29:11.962168,0,1132,1.0,1,4.1
2025-09-02T09:29:12.462411,0,1132,1.0,1,4.3
2025-09-02T09:29:12.962640,0,1132,1.0,1,4.3
2025-09-02T09:29:13.462860,0,1132,1.0,1,6.2
2025-09-02T09:29:13.963081,0,1132,1.0,1,4.3
2025-09-02T09:29:14.463306,0,1132,1.0,1,4.2
2025-09-02T09:29:14.963538,0,1132,1.0,1,4.3
2025-09-02T09:29:15.463771,0,1132,1.0,1,7.4
2025-09-02T09:29:15.964006,0,1132,1.0,1,4.4
2025-09-02T09:29:16.464230,0,1132,1.0,1,4.1
2025-09-02T09:29:16.964490,0,1132,1.0,1,4.6
2025-09-02T09:29:17.464750,6,1138,1.0,1,8.9
2025-09-02T09:29:17.964976,2,1140,1.0,1,8.8
2025-09-02T09:29:18.465248,0,1140,1.0,1,6.8
2025-09-02T09:29:18.965557,0,1140,1.0,1,6.2
2025-09-02T09:29:19.465785,0,1140,1.0,1,7.0
2025-09-02T09:29:19.966015,0,1140,1.0,1,4.1
2025-09-02T09:29:20.466291,0,1140,1.0,1,4.6
2025-09-02T09:29:20.966519,0,1140,1.0,1,4.1
2025-09-02T09:29:21.466755,0,1140,1.0,1,6.7
2025-09-02T09:29:21.966987,0,1140,1.0,1,4.1
2025-09-02T09:29:22.467220,0,1140,1.0,1,4.0
2025-09-02T09:29:22.967455,0,1140,1.0,1,3.8
2025-09-02T09:29:23.467680,0,1140,1.0,1,6.2
2025-09-02T09:29:23.967913,0,1140,1.0,1,4.3
2025-09-02T09:29:24.468169,0,1140,1.0,1,4.0
2025-09-02T09:29:24.968407,0,1140,1.0,1,4.0
2025-09-02T09:29:25.468654,0,1140,1.0,1,7.1
2025-09-02T09:29:25.968871,3,1143,1.0,1,4.3
2025-09-02T09:29:26.469080,3,1146,1.0,1,4.1
2025-09-02T09:29:26.969367,0,1146,1.0,1,4.0
2025-09-02T09:29:27.469551,0,1146,1.0,1,6.2
2025-09-02T09:29:27.969781,1,1147,1.0,1,4.2
2025-09-02T09:29:28.470006,1,1148,1.0,1,4.0
2025-09-02T09:29:28.970242,0,1148,1.0,1,4.1
2025-09-02T09:29:29.470479,1,1149,1.0,1,6.4
2025-09-02T09:29:29.970707,1,1150,1.0,1,4.0
2025-09-02T09:29:30.470940,0,1150,1.0,1,4.1
2025-09-02T09:29:30.971179,0,1150,1.0,1,4.2
2025-09-02T09:29:31.471437,0,1150,1.0,1,6.0
2025-09-02T09:29:31.971672,2,1152,1.0,1,4.6
2025-09-02T09:29:32.471904,1,1153,1.0,1,4.0
2025-09-02T09:29:32.972129,1,1154,1.0,1,4.1
2025-09-02T09:29:33.472463,0,1154,1.0,1,6.1
2025-09-02T09:29:33.972727,0,1154,1.0,1,4.1
2025-09-02T09:29:34.472986,0,1154,1.0,1,3.8
2025-09-02T09:29:34.973220,0,1154,1.0,1,4.2
2025-09-02T09:29:35.473451,0,1154,1.0,1,4.0
2025-09-02T09:29:35.973696,1,1155,1.0,1,7.2
2025-09-02T09:29:36.474049,0,1155,1.0,1,4.0
2025-09-02T09:29:36.974252,1,1156,1.0,1,3.9
2025-09-02T09:29:37.474505,1,1157,1.0,1,4.1
2025-09-02T09:29:37.974775,1,1158,1.0,1,6.5
2025-09-02T09:29:38.475051,1,1159,1.0,1,4.1
2025-09-02T09:29:38.975301,0,1159,1.0,1,4.2
2025-09-02T09:29:39.475524,0,1159,1.0,1,4.2
2025-09-02T09:29:39.975752,0,1159,1.0,1,6.3
2025-09-02T09:29:40.475984,1,1160,1.0,1,4.0
2025-09-02T09:29:40.976273,0,1160,1.0,1,4.5
2025-09-02T09:29:41.476563,1,1161,1.0,1,4.0
2025-09-02T09:29:41.976787,1,1162,1.0,1,6.4
2025-09-02T09:29:42.477011,0,1162,1.0,1,3.9
2025-09-02T09:29:42.977284,0,1162,1.0,1,3.9
2025-09-02T09:29:43.477495,0,1162,1.0,1,3.9
2025-09-02T09:29:43.977786,1,1163,1.0,1,6.5
2025-09-02T09:29:44.478111,1,1164,1.0,1,4.1
2025-09-02T09:29:44.978569,0,1164,1.0,1,4.0
2025-09-02T09:29:45.478917,2,1166,1.0,1,4.0
2025-09-02T09:29:45.979245,1,1167,1.0,1,4.3
2025-09-02T09:29:46.479509,0,1167,1.0,1,6.2
2025-09-02T09:29:46.979771,1,1168,1.0,1,4.2
2025-09-02T09:29:47.479996,2,1170,1.0,1,4.0
2025-09-02T09:29:47.980255,0,1170,1.0,1,6.1
2025-09-02T09:29:48.480482,2,1172,1.0,1,4.3
2025-09-02T09:29:48.980722,0,1172,1.0,1,4.1
2025-09-02T09:29:49.481017,1,1173,1.0,1,6.8
2025-09-02T09:29:49.981297,1,1174,1.0,1,4.2
2025-09-02T09:29:50.481593,2,1176,1.0,1,4.3
2025-09-02T09:29:50.981799,2,1178,1.0,1,4.3
2025-09-02T09:29:51.482074,0,1178,1.0,1,4.1
2025-09-02T09:29:51.982275,1,1179,1.0,1,4.4
2025-09-02T09:29:52.482475,0,1179,1.0,1,4.1
2025-09-02T09:29:52.982704,1,1180,1.0,1,4.1
2025-09-02T09:29:53.482926,1,1181,1.0,1,4.1
2025-09-02T09:29:53.983159,0,1181,1.0,1,4.2
2025-09-02T09:29:54.483392,5,1186,1.0,1,4.4
2025-09-02T09:29:54.983715,1,1187,1.0,1,3.8
2025-09-02T09:29:55.483949,0,1187,1.0,1,3.8
2025-09-02T09:29:55.984241,0,1187,1.0,1,7.1
2025-09-02T09:29:56.484523,0,1187,1.0,1,4.5
2025-09-02T09:29:56.984838,0,1187,1.0,1,4.1
2025-09-02T09:29:57.485072,1,1188,1.0,1,3.9
2025-09-02T09:29:57.985291,0,1188,1.0,1,6.2
2025-09-02T09:29:58.485487,6,1194,1.0,1,5.0
2025-09-02T09:29:58.985743,0,1194,1.0,1,4.1
2025-09-02T09:29:59.485993,1,1195,1.0,1,4.3
2025-09-02T09:29:59.986212,0,1195,1.0,1,6.1
2025-09-02T09:30:00.486449,0,1195,1.0,1,4.1
2025-09-02T09:30:00.986696,0,1195,1.0,1,4.1
2025-09-02T09:30:01.486927,0,1195,1.0,1,4.0
2025-09-02T09:30:01.987160,0,1195,1.0,1,7.0
2025-09-02T09:30:02.487392,0,1195,1.0,1,4.3
2025-09-02T09:30:02.987673,0,1195,1.0,1,4.1
2025-09-02T09:30:03.487907,0,1195,1.0,1,4.0
2025-09-02T09:30:03.988140,0,1195,1.0,1,6.8
2025-09-02T09:30:04.488447,0,1195,1.0,1,4.3
2025-09-02T09:30:04.988691,0,1195,1.0,1,4.1
2025-09-02T09:30:05.488982,0,1195,1.0,1,4.1
2025-09-02T09:30:05.989204,0,1195,1.0,1,6.7
2025-09-02T09:30:06.489430,0,1195,1.0,1,4.1
2025-09-02T09:30:06.989669,0,1195,1.0,1,4.1
2025-09-02T09:30:07.489901,0,1195,1.0,1,4.1
2025-09-02T09:30:07.990127,0,1195,1.0,1,6.3
2025-09-02T09:30:08.490404,0,1195,1.0,1,4.1
2025-09-02T09:30:08.990685,0,1195,1.0,1,4.1
2025-09-02T09:30:09.490973,0,1195,1.0,1,4.2
2025-09-02T09:30:09.991228,0,1195,1.0,1,6.3
2025-09-02T09:30:10.491483,0,1195,1.0,1,4.2
2025-09-02T09:30:10.991715,0,1195,1.0,1,4.4
2025-09-02T09:30:11.491948,0,1195,1.0,1,4.1
2025-09-02T09:30:11.992171,0,1195,1.0,1,4.1
2025-09-02T09:30:12.492464,0,1195,1.0,1,7.2
2025-09-02T09:30:12.992699,0,1195,1.0,1,4.3
2025-09-02T09:30:13.492927,0,1195,1.0,1,4.1
2025-09-02T09:30:13.993228,0,1195,1.0,1,4.1
2025-09-02T09:30:14.493466,0,1195,1.0,1,7.7
2025-09-02T09:30:14.993703,0,1195,1.0,1,4.2
2025-09-02T09:30:15.493983,0,1195,1.0,1,4.1
2025-09-02T09:30:15.994210,0,1195,1.0,1,4.1
2025-09-02T09:30:16.494445,0,1195,1.0,1,7.3
2025-09-02T09:30:16.994680,0,1195,1.0,1,4.1
2025-09-02T09:30:17.494905,0,1195,1.0,1,4.1
2025-09-02T09:30:17.995192,0,1195,1.0,1,4.1
2025-09-02T09:30:18.495468,0,1195,1.0,1,6.8
2025-09-02T09:30:18.995697,0,1195,1.0,1,4.1
2025-09-02T09:30:19.496004,0,1195,1.0,1,4.6
2025-09-02T09:30:19.996253,0,1195,1.0,1,4.3
2025-09-02T09:30:20.496473,0,1195,1.0,1,8.3
2025-09-02T09:30:20.996670,0,1195,1.0,1,4.7
2025-09-02T09:30:21.496919,0,1195,1.0,1,4.3
2025-09-02T09:30:21.997264,0,1195,1.0,1,4.5
2025-09-02T09:30:22.497601,0,1195,1.0,1,6.3
2025-09-02T09:30:22.997929,0,1195,1.0,1,4.3
2025-09-02T09:30:23.498240,0,1195,1.0,1,4.3
2025-09-02T09:30:23.998573,0,1195,1.0,1,5.4
2025-09-02T09:30:24.498911,0,1195,1.0,1,5.5
2025-09-02T09:30:24.999209,0,1195,1.0,1,4.2
2025-09-02T09:30:25.499518,0,1195,1.0,1,4.5
2025-09-02T09:30:25.999886,0,1195,1.0,1,6.8
2025-09-02T09:30:26.500262,0,1195,1.0,1,5.4
2025-09-02T09:30:27.000641,0,1195,1.0,1,4.3
2025-09-02T09:30:27.500974,0,1195,1.0,1,3.6
2025-09-02T09:30:28.001300,0,1195,1.0,1,4.3
2025-09-02T09:30:28.501677,0,1195,1.0,1,7.5
2025-09-02T09:30:29.002048,0,1195,1.0,1,4.5
2025-09-02T09:30:29.502429,0,1195,1.0,1,4.3
2025-09-02T09:30:30.002802,0,1195,1.0,1,4.2
2025-09-02T09:30:30.503171,0,1195,1.0,1,6.5
2025-09-02T09:30:31.003548,0,1195,1.0,1,4.5
2025-09-02T09:30:31.503932,0,1195,1.0,1,4.3
2025-09-02T09:30:32.004308,0,1195,1.0,1,4.3
2025-09-02T09:30:32.504694,0,1195,1.0,1,6.7
2025-09-02T09:30:33.005068,0,1195,1.0,1,4.1
2025-09-02T09:30:33.505456,0,1195,1.0,1,4.3
2025-09-02T09:30:34.005688,0,1195,1.0,1,4.5
2025-09-02T09:30:34.505915,0,1195,1.0,1,7.2
2025-09-02T09:30:35.006147,0,1195,1.0,1,5.7
2025-09-02T09:30:35.506390,0,1195,1.0,1,4.3
2025-09-02T09:30:36.006624,0,1195,1.0,1,4.5
2025-09-02T09:30:36.506861,0,1195,1.0,1,6.9
2025-09-02T09:30:37.007091,0,1195,1.0,1,4.4
2025-09-02T09:30:37.507320,0,1195,1.0,1,4.3
2025-09-02T09:30:38.007562,0,1195,1.0,1,4.8
2025-09-02T09:30:38.507791,0,1195,1.0,1,7.5
2025-09-02T09:30:39.008015,0,1195,1.0,1,4.5
2025-09-02T09:30:39.508239,0,1195,1.0,1,4.3
2025-09-02T09:30:40.008585,0,1195,1.0,1,6.3
2025-09-02T09:30:40.508878,0,1195,1.0,1,4.6
2025-09-02T09:30:41.009095,0,1195,1.0,1,4.8
2025-09-02T09:30:41.509382,0,1195,1.0,1,4.3
2025-09-02T09:30:42.009607,0,1195,1.0,1,7.0
2025-09-02T09:30:42.509905,0,1195,1.0,1,4.8
2025-09-02T09:30:43.010138,0,1195,1.0,1,4.3
2025-09-02T09:30:43.510426,0,1195,1.0,1,4.2
2025-09-02T09:30:44.010757,0,1195,1.0,1,4.0
2025-09-02T09:30:44.510997,0,1195,1.0,1,5.8
2025-09-02T09:30:45.011221,0,1195,1.0,1,4.3
2025-09-02T09:30:45.511427,0,1195,1.0,1,4.3
2025-09-02T09:30:46.011619,0,1195,1.0,1,4.4
2025-09-02T09:30:46.511829,0,1195,1.0,1,6.7
2025-09-02T09:30:47.012071,0,1195,1.0,1,5.6
2025-09-02T09:30:47.512301,0,1195,1.0,1,4.3
2025-09-02T09:30:48.012488,0,1195,1.0,1,4.5
2025-09-02T09:30:48.512708,0,1195,1.0,1,6.4
2025-09-02T09:30:49.012941,0,1195,1.0,1,4.3
2025-09-02T09:30:49.513174,0,1195,1.0,1,4.5
2025-09-02T09:30:50.013415,0,1195,1.0,1,6.1
2025-09-02T09:30:50.513649,0,1195,1.0,1,4.3
2025-09-02T09:30:51.013884,0,1195,1.0,1,4.5
2025-09-02T09:30:51.514140,0,1195,1.0,1,4.1
2025-09-02T09:30:52.014383,0,1195,1.0,1,4.2
2025-09-02T09:30:52.514617,0,1195,1.0,1,4.4
2025-09-02T09:30:53.014844,0,1195,1.0,1,4.2
2025-09-02T09:30:53.515074,0,1195,1.0,1,4.2
2025-09-02T09:30:54.015304,0,1195,1.0,1,4.2
2025-09-02T09:30:54.515538,0,1195,1.0,1,4.3
2025-09-02T09:30:55.015752,0,1195,1.0,1,4.3
2025-09-02T09:30:55.515983,0,1195,1.0,1,4.3
2025-09-02T09:30:56.016221,1,1196,1.0,1,7.2
2025-09-02T09:30:56.516489,0,1196,1.0,1,7.5
2025-09-02T09:30:57.016719,0,1196,1.0,1,8.8
2025-09-02T09:30:57.516946,0,1196,1.0,1,5.9
2025-09-02T09:30:58.017161,0,1196,1.0,1,7.1
2025-09-02T09:30:58.517405,1,1197,1.0,1,4.1
2025-09-02T09:30:59.017629,0,1197,1.0,1,4.1
2025-09-02T09:30:59.517869,0,1197,1.0,1,4.1
2025-09-02T09:31:00.018097,0,1197,1.0,1,6.0
2025-09-02T09:31:00.518313,0,1197,1.0,1,4.0
2025-09-02T09:31:01.018542,0,1197,1.0,1,4.1
2025-09-02T09:31:01.518779,0,1197,1.0,1,4.1
2025-09-02T09:31:02.019115,0,1197,1.0,1,3.5
2025-09-02T09:31:02.519361,0,1197,1.0,1,6.2
2025-09-02T09:31:03.019575,0,1197,1.0,1,4.1
2025-09-02T09:31:03.519800,0,1197,1.0,1,4.1
2025-09-02T09:31:04.020032,0,1197,1.0,1,4.2
2025-09-02T09:31:04.520261,0,1197,1.0,1,7.0
2025-09-02T09:31:05.020474,0,1197,1.0,1,4.1
2025-09-02T09:31:05.520696,0,1197,1.0,1,4.0
2025-09-02T09:31:06.020930,0,1197,1.0,1,4.1
2025-09-02T09:31:06.521166,0,1197,1.0,1,6.3
2025-09-02T09:31:07.021408,0,1197,1.0,1,4.2
2025-09-02T09:31:07.521626,0,1197,1.0,1,4.1
2025-09-02T09:31:08.021861,0,1197,1.0,1,4.4
2025-09-02T09:31:08.522096,0,1197,1.0,1,6.5
2025-09-02T09:31:09.022320,0,1197,1.0,1,3.8
2025-09-02T09:31:09.522561,0,1197,1.0,1,4.0
2025-09-02T09:31:10.022782,0,1197,1.0,1,4.1
2025-09-02T09:31:10.523005,0,1197,1.0,1,6.7
2025-09-02T09:31:11.023233,0,1197,1.0,1,4.3
2025-09-02T09:31:11.523480,0,1197,1.0,1,4.6
2025-09-02T09:31:12.023725,0,1197,1.0,1,4.0
2025-09-02T09:31:12.523990,0,1197,1.0,1,6.1
2025-09-02T09:31:13.024218,0,1197,1.0,1,5.1
2025-09-02T09:31:13.524453,0,1197,1.0,1,5.7
2025-09-02T09:31:14.024677,0,1197,1.0,1,5.0
2025-09-02T09:31:14.524910,0,1197,1.0,1,7.6
2025-09-02T09:31:15.028367,3,1200,1.0,1,7.3
2025-09-02T09:31:15.528605,3,1203,1.0,1,8.5
2025-09-02T09:31:16.028836,1,1204,1.0,1,6.4
2025-09-02T09:31:16.529047,1,1205,1.0,1,6.2
2025-09-02T09:31:17.029341,0,1205,1.0,1,5.0
2025-09-02T09:31:17.529575,0,1205,1.0,1,4.1
2025-09-02T09:31:18.029867,0,1205,1.0,1,6.4
2025-09-02T09:31:18.530162,0,1205,1.0,1,6.3
2025-09-02T09:31:19.030454,16,1221,1.0,1,8.1
2025-09-02T09:31:19.530732,0,1221,1.0,1,6.0
2025-09-02T09:31:20.030959,0,1221,1.0,1,6.3
2025-09-02T09:31:20.531177,0,1221,1.0,1,4.5
2025-09-02T09:31:21.031420,0,1221,1.0,1,4.6
2025-09-02T09:31:21.531652,0,1221,1.0,1,4.0
2025-09-02T09:31:22.031880,0,1221,1.0,1,6.5
2025-09-02T09:31:22.532153,0,1221,1.0,1,4.1
2025-09-02T09:31:23.032385,0,1221,1.0,1,4.0
2025-09-02T09:31:23.532612,0,1221,1.0,1,4.1
2025-09-02T09:31:24.032836,0,1221,1.0,1,6.3
2025-09-02T09:31:24.533156,0,1221,1.0,1,3.8
2025-09-02T09:31:25.033448,0,1221,1.0,1,4.1
2025-09-02T09:31:25.533719,0,1221,1.0,1,4.1
2025-09-02T09:31:26.033958,0,1221,1.0,1,6.2
2025-09-02T09:31:26.534198,0,1221,1.0,1,4.0
2025-09-02T09:31:27.034480,0,1221,1.0,1,4.1
2025-09-02T09:31:27.534709,0,1221,1.0,1,4.0
2025-09-02T09:31:28.034994,0,1221,1.0,1,6.5
2025-09-02T09:31:28.535225,0,1221,1.0,1,5.4
2025-09-02T09:31:29.035451,0,1221,1.0,1,4.1
2025-09-02T09:31:29.535688,0,1221,1.0,1,4.0
2025-09-02T09:31:30.035912,0,1221,1.0,1,6.1
2025-09-02T09:31:30.536149,0,1221,1.0,1,4.3
2025-09-02T09:31:31.036389,0,1221,1.0,1,4.0
2025-09-02T09:31:31.536613,0,1221,1.0,1,4.1
2025-09-02T09:31:32.036843,0,1221,1.0,1,4.1
2025-09-02T09:31:32.537080,0,1221,1.0,1,6.3
2025-09-02T09:31:33.037322,0,1221,1.0,1,4.1
2025-09-02T09:31:33.537579,0,1221,1.0,1,4.1
2025-09-02T09:31:34.037806,0,1221,1.0,1,4.1
2025-09-02T09:31:34.538048,0,1221,1.0,1,6.0
2025-09-02T09:31:35.038287,0,1221,1.0,1,4.0
2025-09-02T09:31:35.538500,0,1221,1.0,1,4.3
2025-09-02T09:31:36.038731,0,1221,1.0,1,4.5
2025-09-02T09:31:36.538960,1,1222,1.0,1,7.0
2025-09-02T09:31:37.039210,1,1223,1.0,1,9.8
2025-09-02T09:31:37.539471,0,1223,1.0,1,7.7
2025-09-02T09:31:38.039710,0,1223,1.0,1,7.6
2025-09-02T09:31:38.539934,0,1223,1.0,1,11.4
2025-09-02T09:31:39.040241,0,1223,1.0,1,8.8
2025-09-02T09:31:39.540528,2,1225,1.0,1,6.7
2025-09-02T09:31:40.040832,0,1225,1.0,1,5.5
2025-09-02T09:31:40.541072,0,1225,1.0,1,5.7
2025-09-02T09:31:41.041308,0,1225,1.0,1,4.5
2025-09-02T09:31:41.541543,0,1225,1.0,1,4.0
2025-09-02T09:31:42.041827,0,1225,1.0,1,6.0
2025-09-02T09:31:42.542053,0,1225,1.0,1,4.8
2025-09-02T09:31:43.042277,0,1225,1.0,1,4.2
2025-09-02T09:31:43.542469,0,1225,1.0,1,4.1
2025-09-02T09:31:44.042735,0,1225,1.0,1,6.2
2025-09-02T09:31:44.542958,0,1225,1.0,1,4.1
2025-09-02T09:31:45.043190,0,1225,1.0,1,4.3
2025-09-02T09:31:45.543412,0,1225,1.0,1,4.1
2025-09-02T09:31:46.043647,0,1225,1.0,1,6.5
2025-09-02T09:31:46.543933,0,1225,1.0,1,4.0
2025-09-02T09:31:47.044226,0,1225,1.0,1,4.1
2025-09-02T09:31:47.544456,0,1225,1.0,1,4.0
2025-09-02T09:31:48.044679,0,1225,1.0,1,6.4
2025-09-02T09:31:48.544910,0,1225,1.0,1,3.9
2025-09-02T09:31:49.045134,0,1225,1.0,1,4.1
2025-09-02T09:31:49.545410,0,1225,1.0,1,6.4
2025-09-02T09:31:50.045720,0,1225,1.0,1,4.3
2025-09-02T09:31:50.545936,0,1225,1.0,1,4.1
2025-09-02T09:31:51.046164,0,1225,1.0,1,4.2
2025-09-02T09:31:51.546379,0,1225,1.0,1,4.1
2025-09-02T09:31:52.046610,0,1225,1.0,1,4.0
2025-09-02T09:31:52.546819,0,1225,1.0,1,4.3
2025-09-02T09:31:53.047117,0,1225,1.0,1,6.5
2025-09-02T09:31:53.547348,0,1225,1.0,1,4.1
2025-09-02T09:31:54.047580,0,1225,1.0,1,3.9
2025-09-02T09:31:54.547802,0,1225,1.0,1,4.0
2025-09-02T09:31:55.048077,0,1225,1.0,1,6.3
2025-09-02T09:31:55.548294,0,1225,1.0,1,4.1
2025-09-02T09:31:56.048496,0,1225,1.0,1,4.3
2025-09-02T09:31:56.548715,0,1225,1.0,1,4.1
2025-09-02T09:31:57.049005,0,1225,1.0,1,6.7
2025-09-02T09:31:57.549310,0,1225,1.0,1,4.3
2025-09-02T09:31:58.049554,0,1225,1.0,1,4.3
2025-09-02T09:31:58.549777,0,1225,1.0,1,4.1
2025-09-02T09:31:59.049998,0,1225,1.0,1,6.8
2025-09-02T09:31:59.550225,0,1225,1.0,1,4.1
2025-09-02T09:32:00.050469,0,1225,1.0,1,4.3
2025-09-02T09:32:00.550690,0,1225,1.0,1,4.0
2025-09-02T09:32:01.050920,0,1225,1.0,1,6.6
2025-09-02T09:32:01.551189,0,1225,1.0,1,4.1
2025-09-02T09:32:02.051488,0,1225,1.0,1,4.3
2025-09-02T09:32:02.551705,0,1225,1.0,1,4.4
2025-09-02T09:32:03.051936,0,1225,1.0,1,6.2
2025-09-02T09:32:03.552149,0,1225,1.0,1,4.3
2025-09-02T09:32:04.052371,0,1225,1.0,1,4.3
2025-09-02T09:32:04.552600,0,1225,1.0,1,4.3
2025-09-02T09:32:05.052921,0,1225,1.0,1,6.3
2025-09-02T09:32:05.553236,0,1225,1.0,1,4.2
2025-09-02T09:32:06.053480,0,1225,1.0,1,4.5
2025-09-02T09:32:06.553712,0,1225,1.0,1,4.3
2025-09-02T09:32:07.053938,0,1225,1.0,1,6.2
2025-09-02T09:32:07.554152,0,1225,1.0,1,3.9
2025-09-02T09:32:08.054381,0,1225,1.0,1,4.3
2025-09-02T09:32:08.554685,0,1225,1.0,1,4.3
2025-09-02T09:32:09.054926,0,1225,1.0,1,6.3
2025-09-02T09:32:09.555161,0,1225,1.0,1,4.3
2025-09-02T09:32:10.055402,0,1225,1.0,1,4.2
2025-09-02T09:32:10.555638,0,1225,1.0,1,4.4
2025-09-02T09:32:11.055895,1,1226,1.0,1,5.1
2025-09-02T09:32:11.556119,1,1227,1.0,1,8.9
2025-09-02T09:32:12.056350,0,1227,1.0,1,6.0
2025-09-02T09:32:12.556599,1,1228,1.0,1,4.1
2025-09-02T09:32:13.056953,0,1228,1.0,1,7.1
2025-09-02T09:32:13.557266,0,1228,1.0,1,4.5
2025-09-02T09:32:14.057548,0,1228,1.0,1,4.2
2025-09-02T09:32:14.557841,0,1228,1.0,1,4.1
2025-09-02T09:32:15.058151,0,1228,1.0,1,4.2
2025-09-02T09:32:15.558472,0,1228,1.0,1,6.3
2025-09-02T09:32:16.058705,0,1228,1.0,1,4.3
2025-09-02T09:32:16.558928,0,1228,1.0,1,4.1
2025-09-02T09:32:17.059243,0,1228,1.0,1,6.0
2025-09-02T09:32:17.559468,0,1228,1.0,1,4.5
2025-09-02T09:32:18.059695,0,1228,1.0,1,4.5
2025-09-02T09:32:18.559914,0,1228,1.0,1,4.0
2025-09-02T09:32:19.060192,0,1228,1.0,1,6.1
2025-09-02T09:32:19.560496,0,1228,1.0,1,4.1
2025-09-02T09:32:20.060765,0,1228,1.0,1,3.6
2025-09-02T09:32:20.561018,0,1228,1.0,1,4.0
2025-09-02T09:32:21.061249,0,1228,1.0,1,4.6
2025-09-02T09:32:21.561458,0,1228,1.0,1,6.7
2025-09-02T09:32:22.061680,0,1228,1.0,1,5.1
2025-09-02T09:32:22.561899,0,1228,1.0,1,4.0
2025-09-02T09:32:23.062133,0,1228,1.0,1,4.2
2025-09-02T09:32:23.562363,0,1228,1.0,1,6.2
2025-09-02T09:32:24.062592,0,1228,1.0,1,4.7
2025-09-02T09:32:24.562832,0,1228,1.0,1,4.5
2025-09-02T09:32:25.063072,0,1228,1.0,1,4.3
2025-09-02T09:32:25.563301,0,1228,1.0,1,6.3
2025-09-02T09:32:26.063486,0,1228,1.0,1,4.3
2025-09-02T09:32:26.563717,0,1228,1.0,1,6.1
2025-09-02T09:32:27.063952,0,1228,1.0,1,5.6
2025-09-02T09:32:27.564181,0,1228,1.0,1,7.6
2025-09-02T09:32:28.064415,0,1228,1.0,1,5.3
2025-09-02T09:32:28.564646,0,1228,1.0,1,5.6
2025-09-02T09:32:29.064867,0,1228,1.0,1,4.4
2025-09-02T09:32:29.565092,0,1228,1.0,1,6.1
2025-09-02T09:32:30.065323,0,1228,1.0,1,4.1
2025-09-02T09:32:30.565553,0,1228,1.0,1,4.6
2025-09-02T09:32:31.065794,0,1228,1.0,1,4.4
2025-09-02T09:32:31.566033,0,1228,1.0,1,6.7
2025-09-02T09:32:32.066270,0,1228,1.0,1,4.3
2025-09-02T09:32:32.566475,0,1228,1.0,1,4.3
2025-09-02T09:32:33.066699,0,1228,1.0,1,4.3
2025-09-02T09:32:33.566929,0,1228,1.0,1,6.7
2025-09-02T09:32:34.067154,0,1228,1.0,1,4.3
2025-09-02T09:32:34.567369,0,1228,1.0,1,4.3
2025-09-02T09:32:35.067658,0,1228,1.0,1,3.7
2025-09-02T09:32:35.567946,0,1228,1.0,1,4.8
2025-09-02T09:32:36.068192,0,1228,1.0,1,6.0
2025-09-02T09:32:36.568422,0,1228,1.0,1,4.4
2025-09-02T09:32:37.068647,0,1228,1.0,1,4.2
2025-09-02T09:32:37.568883,0,1228,1.0,1,6.3
2025-09-02T09:32:38.069118,0,1228,1.0,1,4.3
2025-09-02T09:32:38.569355,0,1228,1.0,1,4.3
2025-09-02T09:32:39.069578,0,1228,1.0,1,4.5
2025-09-02T09:32:39.569797,0,1228,1.0,1,6.5
2025-09-02T09:32:40.070025,0,1228,1.0,1,4.4
2025-09-02T09:32:40.570250,0,1228,1.0,1,4.6
2025-09-02T09:32:41.070480,0,1228,1.0,1,4.4
2025-09-02T09:32:41.570755,0,1228,1.0,1,6.5
2025-09-02T09:32:42.071004,0,1228,1.0,1,4.3
2025-09-02T09:32:42.571241,0,1228,1.0,1,4.8
2025-09-02T09:32:43.071477,0,1228,1.0,1,4.1
2025-09-02T09:32:43.571766,0,1228,1.0,1,6.5
2025-09-02T09:32:44.072055,0,1228,1.0,1,4.5
2025-09-02T09:32:44.572341,0,1228,1.0,1,4.5
2025-09-02T09:32:45.072585,0,1228,1.0,1,4.3
2025-09-02T09:32:45.572821,0,1228,1.0,1,6.5
2025-09-02T09:32:46.073061,0,1228,1.0,1,4.5
2025-09-02T09:32:46.573296,0,1228,1.0,1,9.3
2025-09-02T09:32:47.073500,0,1228,1.0,1,17.2
2025-09-02T09:32:47.573771,0,1228,1.0,1,7.7
2025-09-02T09:32:48.074007,0,1228,1.0,1,6.5
2025-09-02T09:32:48.574291,0,1228,1.0,1,6.8
2025-09-02T09:32:49.074475,0,1228,1.0,1,4.3
2025-09-02T09:32:49.574707,0,1228,1.0,1,4.8
2025-09-02T09:32:50.074927,0,1228,1.0,1,4.4
2025-09-02T09:32:50.575141,0,1228,1.0,1,4.1
2025-09-02T09:32:51.075461,0,1228,1.0,1,4.2
2025-09-02T09:32:51.575792,0,1228,1.0,1,5.8
2025-09-02T09:32:52.076061,0,1228,1.0,1,5.1
2025-09-02T09:32:52.576294,0,1228,1.0,1,4.4
2025-09-02T09:32:53.076463,0,1228,1.0,1,4.5
2025-09-02T09:32:53.576680,0,1228,1.0,1,6.5
2025-09-02T09:32:54.076909,0,1228,1.0,1,4.5
2025-09-02T09:32:54.577128,2,1230,1.0,1,10.1
2025-09-02T09:32:55.077383,1,1231,1.0,1,5.1
2025-09-02T09:32:55.577615,0,1231,1.0,1,7.1
2025-09-02T09:32:56.077846,0,1231,1.0,1,4.3
2025-09-02T09:32:56.578066,0,1231,1.0,1,4.2
2025-09-02T09:32:57.078293,0,1231,1.0,1,4.1
2025-09-02T09:32:57.578474,0,1231,1.0,1,6.2
2025-09-02T09:32:58.078701,0,1231,1.0,1,4.7
2025-09-02T09:32:58.578941,0,1231,1.0,1,12.0
2025-09-02T09:32:59.079166,0,1231,1.0,1,8.1
2025-09-02T09:32:59.579401,0,1231,1.0,1,8.1
2025-09-02T09:33:00.079638,0,1231,1.0,1,6.8
2025-09-02T09:33:00.579861,0,1231,1.0,1,5.2
2025-09-02T09:33:01.080111,4,1235,1.0,1,12.6
2025-09-02T09:33:01.580343,1,1236,1.0,1,8.5
2025-09-02T09:33:02.080608,3,1239,1.0,1,8.0
2025-09-02T09:33:02.580851,3,1242,1.0,1,11.1
2025-09-02T09:33:03.081082,0,1242,1.0,1,11.0
2025-09-02T09:33:03.581315,0,1242,1.0,1,10.6
2025-09-02T09:33:04.081595,0,1242,1.0,1,8.4
2025-09-02T09:33:04.581815,2,1244,1.0,1,8.5
2025-09-02T09:33:05.082052,1,1245,1.0,1,4.5
2025-09-02T09:33:05.582286,0,1245,1.0,1,6.3
2025-09-02T09:33:06.082478,0,1245,1.0,1,4.3
2025-09-02T09:33:06.582699,0,1245,1.0,1,4.2
2025-09-02T09:33:07.082910,37,1282,1.0,1,7.0
2025-09-02T09:33:07.583225,0,1282,1.0,1,6.9
2025-09-02T09:33:08.083450,0,1282,1.0,1,4.1
2025-09-02T09:33:08.583668,0,1282,1.0,1,4.7
2025-09-02T09:33:09.083914,0,1282,1.0,1,13.2
2025-09-02T09:33:09.584215,0,1282,1.0,1,11.0
2025-09-02T09:33:10.084449,0,1282,1.0,1,6.6
2025-09-02T09:33:10.584674,0,1282,1.0,1,6.8
2025-09-02T09:33:11.084902,0,1282,1.0,1,7.2
2025-09-02T09:33:11.585141,0,1282,1.0,1,14.6
2025-09-02T09:33:12.085374,0,1282,1.0,1,7.1
2025-09-02T09:33:12.585602,0,1282,1.0,1,6.5
2025-09-02T09:33:13.085819,0,1282,1.0,1,6.5
2025-09-02T09:33:13.586045,0,1282,1.0,1,14.7
2025-09-02T09:33:14.086316,0,1282,1.0,1,7.6
2025-09-02T09:33:14.586552,0,1282,1.0,1,6.3
2025-09-02T09:33:15.086777,0,1282,1.0,1,7.5
2025-09-02T09:33:15.587020,0,1282,1.0,1,12.1
2025-09-02T09:33:16.087248,0,1282,1.0,1,5.1
2025-09-02T09:33:16.587465,0,1282,1.0,1,5.7
2025-09-02T09:33:17.087699,0,1282,1.0,1,7.2
2025-09-02T09:33:17.587929,0,1282,1.0,1,12.6
2025-09-02T09:33:18.088143,0,1282,1.0,1,5.5
2025-09-02T09:33:18.588388,0,1282,1.0,1,11.7
2025-09-02T09:33:19.088612,0,1282,1.0,1,7.8
2025-09-02T09:33:19.588865,0,1282,1.0,1,10.1
2025-09-02T09:33:20.089113,0,1282,1.0,1,11.1
2025-09-02T09:33:20.589349,0,1282,1.0,1,4.5
2025-09-02T09:33:21.089650,0,1282,1.0,1,6.7
2025-09-02T09:33:21.589913,0,1282,1.0,1,10.2
2025-09-02T09:33:22.090157,0,1282,1.0,1,10.1
2025-09-02T09:33:22.590421,0,1282,1.0,1,4.5
2025-09-02T09:33:23.090715,0,1282,1.0,1,7.0
2025-09-02T09:33:23.590959,0,1282,1.0,1,5.1
2025-09-02T09:33:24.091199,0,1282,1.0,1,14.7
2025-09-02T09:33:24.591436,0,1282,1.0,1,8.3
2025-09-02T09:33:25.091690,0,1282,1.0,1,7.7
2025-09-02T09:33:25.591939,0,1282,1.0,1,10.5
2025-09-02T09:33:26.092203,0,1282,1.0,1,10.4
2025-09-02T09:33:26.592448,0,1282,1.0,1,11.6
2025-09-02T09:33:27.092682,0,1282,1.0,1,4.9
2025-09-02T09:33:27.592910,0,1282,1.0,1,6.3
2025-09-02T09:33:28.093127,0,1282,1.0,1,7.7
2025-09-02T09:33:28.593358,0,1282,1.0,1,10.6
2025-09-02T09:33:29.093577,0,1282,1.0,1,8.8
2025-09-02T09:33:29.593810,0,1282,1.0,1,5.3
2025-09-02T09:33:30.094046,0,1282,1.0,1,14.8
2025-09-02T09:33:30.594285,0,1282,1.0,1,8.3
2025-09-02T09:33:31.094488,0,1282,1.0,1,6.4
2025-09-02T09:33:31.594706,3,1285,1.0,1,12.5
2025-09-02T09:33:32.095037,0,1285,1.0,1,11.3
2025-09-02T09:33:32.595270,0,1285,1.0,1,11.3
2025-09-02T09:33:33.095486,1,1286,1.0,1,7.1
2025-09-02T09:33:33.595722,0,1286,1.0,1,11.3
2025-09-02T09:33:34.095951,0,1286,1.0,1,6.3
2025-09-02T09:33:34.596195,0,1286,1.0,1,9.0
2025-09-02T09:33:35.096435,0,1286,1.0,1,6.3
2025-09-02T09:33:35.596661,0,1286,1.0,1,4.3
2025-09-02T09:33:36.096889,0,1286,1.0,1,4.5
2025-09-02T09:33:36.597122,0,1286,1.0,1,6.5
2025-09-02T09:33:37.097400,0,1286,1.0,1,4.2
2025-09-02T09:33:37.597621,0,1286,1.0,1,4.2
2025-09-02T09:33:38.097852,0,1286,1.0,1,4.2
2025-09-02T09:33:38.598091,0,1286,1.0,1,6.4
2025-09-02T09:33:39.098421,0,1286,1.0,1,4.4
2025-09-02T09:33:39.598753,0,1286,1.0,1,4.6
2025-09-02T09:33:40.099047,0,1286,1.0,1,4.1
2025-09-02T09:33:40.599262,0,1286,1.0,1,6.6
2025-09-02T09:33:41.099483,0,1286,1.0,1,4.2
2025-09-02T09:33:41.599716,0,1286,1.0,1,4.4
2025-09-02T09:33:42.099938,0,1286,1.0,1,4.0
2025-09-02T09:33:42.600247,0,1286,1.0,1,6.2
2025-09-02T09:33:43.100485,0,1286,1.0,1,4.5
2025-09-02T09:33:43.600709,0,1286,1.0,1,3.8
2025-09-02T09:33:44.100938,0,1286,1.0,1,4.5
2025-09-02T09:33:44.601224,0,1286,1.0,1,6.3
2025-09-02T09:33:45.101454,0,1286,1.0,1,4.1
2025-09-02T09:33:45.601681,0,1286,1.0,1,4.5
2025-09-02T09:33:46.101907,0,1286,1.0,1,4.3
2025-09-02T09:33:46.602180,0,1286,1.0,1,6.6
2025-09-02T09:33:47.102409,0,1286,1.0,1,4.6
2025-09-02T09:33:47.602693,0,1286,1.0,1,4.1
2025-09-02T09:33:48.102919,0,1286,1.0,1,4.1
2025-09-02T09:33:48.603206,0,1286,1.0,1,6.3
2025-09-02T09:33:49.103477,0,1286,1.0,1,4.2
2025-09-02T09:33:49.603742,0,1286,1.0,1,4.5
2025-09-02T09:33:50.103973,0,1286,1.0,1,6.4
2025-09-02T09:33:50.604207,0,1286,1.0,1,4.0
2025-09-02T09:33:51.104439,0,1286,1.0,1,4.3
2025-09-02T09:33:51.604662,0,1286,1.0,1,4.1
2025-09-02T09:33:52.104875,0,1286,1.0,1,4.1
2025-09-02T09:33:52.605094,0,1286,1.0,1,4.3
2025-09-02T09:33:53.105315,0,1286,1.0,1,4.3
2025-09-02T09:33:53.605538,0,1286,1.0,1,5.2
2025-09-02T09:33:54.105772,0,1286,1.0,1,4.8
2025-09-02T09:33:54.605996,0,1286,1.0,1,4.6
2025-09-02T09:33:55.106262,0,1286,1.0,1,4.6
2025-09-02T09:33:55.606489,0,1286,1.0,1,4.2
2025-09-02T09:33:56.106743,1,1287,1.0,1,6.9
2025-09-02T09:33:56.606940,1,1288,1.0,1,4.1
2025-09-02T09:33:57.107175,1,1289,1.0,1,4.6
2025-09-02T09:33:57.607415,1,1290,1.0,1,7.8
2025-09-02T09:33:58.222217,2,1292,1.0,1,8.4
2025-09-02T09:33:58.722532,0,1292,1.0,1,5.1
2025-09-02T09:33:59.222873,0,1292,1.0,1,4.3
2025-09-02T09:33:59.723226,0,1292,1.0,1,4.0
2025-09-02T09:34:00.223516,0,1292,1.0,1,6.0
2025-09-02T09:34:00.723809,0,1292,1.0,1,4.1
2025-09-02T09:34:01.224107,0,1292,1.0,1,8.5
2025-09-02T09:34:01.724406,0,1292,1.0,1,11.9
2025-09-02T09:34:02.224696,0,1292,1.0,1,10.1
2025-09-02T09:34:02.724999,0,1292,1.0,1,6.5
2025-09-02T09:34:03.225280,0,1292,1.0,1,9.0
2025-09-02T09:34:03.725525,0,1292,1.0,1,10.9
2025-09-02T09:34:04.225816,0,1292,1.0,1,6.9
2025-09-02T09:34:04.726098,0,1292,1.0,1,5.8
2025-09-02T09:34:05.226385,0,1292,1.0,1,4.0
2025-09-02T09:34:05.726682,0,1292,1.0,1,4.1
2025-09-02T09:34:06.227016,0,1292,1.0,1,6.5
2025-09-02T09:34:06.727329,0,1292,1.0,1,13.0
2025-09-02T09:34:07.227584,0,1292,1.0,1,7.4
2025-09-02T09:34:07.727897,0,1292,1.0,1,6.3
2025-09-02T09:34:08.228190,0,1292,1.0,1,5.3
2025-09-02T09:34:08.728516,0,1292,1.0,1,6.5
2025-09-02T09:34:09.228817,0,1292,1.0,1,11.1
2025-09-02T09:34:09.729122,0,1292,1.0,1,6.7
2025-09-02T09:34:10.229429,0,1292,1.0,1,5.8
2025-09-02T09:34:10.729740,0,1292,1.0,1,12.0
2025-09-02T09:34:11.230032,0,1292,1.0,1,10.1
2025-09-02T09:34:11.730370,0,1292,1.0,1,5.3
2025-09-02T09:34:12.230679,0,1292,1.0,1,6.9
2025-09-02T09:34:12.730991,0,1292,1.0,1,6.0
2025-09-02T09:34:13.231282,0,1292,1.0,1,4.3
2025-09-02T09:34:13.731575,0,1292,1.0,1,4.1
2025-09-02T09:34:14.231865,0,1292,1.0,1,4.1
2025-09-02T09:34:14.732156,0,1292,1.0,1,6.3
2025-09-02T09:34:15.232455,0,1292,1.0,1,6.1
2025-09-02T09:34:15.732769,0,1292,1.0,1,8.7
2025-09-02T09:34:16.233071,0,1292,1.0,1,8.7
2025-09-02T09:34:16.733417,0,1292,1.0,1,10.9
2025-09-02T09:34:17.233746,0,1292,1.0,1,10.5
2025-09-02T09:34:17.733978,0,1292,1.0,1,9.2
2025-09-02T09:34:18.234192,0,1292,1.0,1,11.3
2025-09-02T09:34:18.734476,0,1292,1.0,1,6.2
2025-09-02T09:34:19.234704,0,1292,1.0,1,5.1
2025-09-02T09:34:19.734940,0,1292,1.0,1,5.2
2025-09-02T09:34:20.235159,0,1292,1.0,1,4.7
2025-09-02T09:34:20.735384,0,1292,1.0,1,5.8
2025-09-02T09:34:21.235603,0,1292,1.0,1,7.3
2025-09-02T09:34:21.735834,0,1292,1.0,1,5.1
2025-09-02T09:34:22.236053,0,1292,1.0,1,4.6
2025-09-02T09:34:22.736359,0,1292,1.0,1,6.9
2025-09-02T09:34:23.236606,0,1292,1.0,1,4.7
2025-09-02T09:34:23.736835,0,1292,1.0,1,4.8
2025-09-02T09:34:24.237120,2,1294,1.0,1,4.3
2025-09-02T09:34:24.737453,0,1294,1.0,1,5.7
2025-09-02T09:34:25.237775,0,1294,1.0,1,4.7
2025-09-02T09:34:25.738085,0,1294,1.0,1,4.5
2025-09-02T09:34:26.238486,0,1294,1.0,1,4.2
2025-09-02T09:34:26.738735,0,1294,1.0,1,4.1
2025-09-02T09:34:27.238988,1,1295,1.0,1,9.3
2025-09-02T09:34:27.739255,0,1295,1.0,1,7.7
2025-09-02T09:34:28.240734,0,1295,1.0,1,7.7
2025-09-02T09:34:28.741022,1,1296,1.0,1,4.8
2025-09-02T09:34:29.241268,0,1296,1.0,1,6.0
2025-09-02T09:34:29.741576,0,1296,1.0,1,4.1
2025-09-02T09:34:30.241815,0,1296,1.0,1,3.9
2025-09-02T09:34:30.742057,0,1296,1.0,1,4.4
2025-09-02T09:34:31.242284,0,1296,1.0,1,6.5
2025-09-02T09:34:31.742545,0,1296,1.0,1,4.4
2025-09-02T09:34:32.242774,0,1296,1.0,1,4.3
2025-09-02T09:34:32.743050,0,1296,1.0,1,4.6
2025-09-02T09:34:33.243278,0,1296,1.0,1,6.3
2025-09-02T09:34:33.743568,0,1296,1.0,1,4.1
2025-09-02T09:34:34.243851,0,1296,1.0,1,4.5
2025-09-02T09:34:34.744143,0,1296,1.0,1,4.1
2025-09-02T09:34:35.244440,0,1296,1.0,1,6.5
2025-09-02T09:34:35.744748,0,1296,1.0,1,4.4
2025-09-02T09:34:36.244989,0,1296,1.0,1,4.5
2025-09-02T09:34:36.745209,0,1296,1.0,1,4.2
2025-09-02T09:34:37.245488,0,1296,1.0,1,6.2
2025-09-02T09:34:37.745718,0,1296,1.0,1,4.3
2025-09-02T09:34:38.245950,0,1296,1.0,1,4.3
2025-09-02T09:34:38.746178,0,1296,1.0,1,4.2
2025-09-02T09:34:39.246457,0,1296,1.0,1,6.7
2025-09-02T09:34:39.746685,0,1296,1.0,1,5.0
2025-09-02T09:34:40.246921,1,1297,1.0,1,6.8
2025-09-02T09:34:40.747368,0,1297,1.0,1,7.9
2025-09-02T09:34:41.247576,4,1301,1.0,1,11.3
2025-09-02T09:34:41.747812,1,1302,1.0,1,5.3
2025-09-02T09:34:42.248049,0,1302,1.0,1,4.7
2025-09-02T09:34:42.748346,0,1302,1.0,1,4.1
2025-09-02T09:34:43.248659,0,1302,1.0,1,6.5
2025-09-02T09:34:43.748942,0,1302,1.0,1,4.1
2025-09-02T09:34:44.249177,0,1302,1.0,1,4.3
2025-09-02T09:34:44.749405,0,1302,1.0,1,4.4
2025-09-02T09:34:45.249632,0,1302,1.0,1,6.0
2025-09-02T09:34:45.749933,0,1302,1.0,1,4.3
2025-09-02T09:34:46.250209,0,1302,1.0,1,4.5
2025-09-02T09:34:46.750438,0,1302,1.0,1,4.2
2025-09-02T09:34:47.250664,0,1302,1.0,1,6.5
2025-09-02T09:34:47.750884,0,1302,1.0,1,4.1
2025-09-02T09:34:48.251113,0,1302,1.0,1,4.2
2025-09-02T09:34:48.751468,0,1302,1.0,1,4.3
2025-09-02T09:34:49.251710,0,1302,1.0,1,6.1
2025-09-02T09:34:49.751996,0,1302,1.0,1,4.5
2025-09-02T09:34:50.252223,0,1302,1.0,1,4.1
2025-09-02T09:34:50.752457,0,1302,1.0,1,6.2
2025-09-02T09:34:51.252729,0,1302,1.0,1,4.3
2025-09-02T09:34:51.753018,0,1302,1.0,1,4.3
2025-09-02T09:34:52.253295,0,1302,1.0,1,4.2
2025-09-02T09:34:52.753580,0,1302,1.0,1,6.4
2025-09-02T09:34:53.253884,0,1302,1.0,1,4.1
2025-09-02T09:34:53.754113,0,1302,1.0,1,4.3
2025-09-02T09:34:54.254342,0,1302,1.0,1,4.1
2025-09-02T09:34:54.754563,0,1302,1.0,1,6.4
2025-09-02T09:34:55.254845,0,1302,1.0,1,4.2
2025-09-02T09:34:55.755069,0,1302,1.0,1,4.3
2025-09-02T09:34:56.255460,0,1302,1.0,1,4.1
2025-09-02T09:34:56.755715,0,1302,1.0,1,4.0
2025-09-02T09:34:57.256075,4,1306,1.0,1,6.5
2025-09-02T09:34:57.756391,1,1307,1.0,1,4.3
2025-09-02T09:34:58.256751,1,1308,1.0,1,6.5
2025-09-02T09:34:58.757043,1,1309,1.0,1,4.1
2025-09-02T09:34:59.257356,0,1309,1.0,1,6.4
2025-09-02T09:34:59.757644,0,1309,1.0,1,4.5
2025-09-02T09:35:00.257866,0,1309,1.0,1,4.0
2025-09-02T09:35:00.758159,0,1309,1.0,1,5.7
2025-09-02T09:35:01.258408,0,1309,1.0,1,4.9
2025-09-02T09:35:01.758634,0,1309,1.0,1,4.4
2025-09-02T09:35:02.258954,0,1309,1.0,1,4.1
2025-09-02T09:35:02.759244,0,1309,1.0,1,4.5
2025-09-02T09:35:03.259502,0,1309,1.0,1,6.3
2025-09-02T09:35:03.759781,0,1309,1.0,1,4.6
2025-09-02T09:35:04.260016,0,1309,1.0,1,5.2
2025-09-02T09:35:04.760237,0,1309,1.0,1,4.1
2025-09-02T09:35:05.260476,0,1309,1.0,1,6.2
2025-09-02T09:35:05.760760,0,1309,1.0,1,4.0
2025-09-02T09:35:06.261020,0,1309,1.0,1,4.5
2025-09-02T09:35:06.761253,0,1309,1.0,1,4.3
2025-09-02T09:35:07.261496,0,1309,1.0,1,6.6
2025-09-02T09:35:07.761719,0,1309,1.0,1,4.1
2025-09-02T09:35:08.261957,0,1309,1.0,1,4.3
2025-09-02T09:35:08.762191,0,1309,1.0,1,4.1
2025-09-02T09:35:09.262476,2,1311,1.0,1,7.9
2025-09-02T09:35:09.762679,0,1311,1.0,1,7.5
2025-09-02T09:35:10.262903,1,1312,1.0,1,6.0
2025-09-02T09:35:10.763109,0,1312,1.0,1,7.7
2025-09-02T09:35:11.263340,0,1312,1.0,1,7.6
2025-09-02T09:35:11.763582,0,1312,1.0,1,14.2
2025-09-02T09:35:12.263820,0,1312,1.0,1,9.3
2025-09-02T09:35:12.764057,0,1312,1.0,1,8.7
2025-09-02T09:35:13.264282,0,1312,1.0,1,6.1
2025-09-02T09:35:13.764477,0,1312,1.0,1,4.0
2025-09-02T09:35:14.264755,0,1312,1.0,1,4.5
2025-09-02T09:35:14.764986,0,1312,1.0,1,6.3
2025-09-02T09:35:15.265197,0,1312,1.0,1,4.3
2025-09-02T09:35:15.765409,0,1312,1.0,1,4.8
2025-09-02T09:35:16.265648,0,1312,1.0,1,4.8
2025-09-02T09:35:16.765877,0,1312,1.0,1,6.6
2025-09-02T09:35:17.266119,0,1312,1.0,1,12.8
2025-09-02T09:35:17.766364,0,1312,1.0,1,7.5
2025-09-02T09:35:18.266610,0,1312,1.0,1,6.8
2025-09-02T09:35:18.766898,0,1312,1.0,1,6.2
2025-09-02T09:35:19.267138,0,1312,1.0,1,5.1
2025-09-02T09:35:19.767352,0,1312,1.0,1,4.2
2025-09-02T09:35:20.267584,0,1312,1.0,1,4.2
2025-09-02T09:35:20.767827,0,1312,1.0,1,9.4
2025-09-02T09:35:21.268072,1,1313,1.0,1,11.2
2025-09-02T09:35:21.768362,0,1313,1.0,1,5.0
2025-09-02T09:35:22.268586,4,1317,1.0,1,6.8
2025-09-02T09:35:22.768909,5,1322,1.0,1,6.7
2025-09-02T09:35:23.269131,1,1323,1.0,1,8.5
2025-09-02T09:35:23.769360,0,1323,1.0,1,4.5
2025-09-02T09:35:24.269587,0,1323,1.0,1,4.2
2025-09-02T09:35:24.769812,0,1323,1.0,1,4.3
2025-09-02T09:35:25.270037,0,1323,1.0,1,6.5
2025-09-02T09:35:25.770260,0,1323,1.0,1,4.6
2025-09-02T09:35:26.270527,0,1323,1.0,1,8.7
2025-09-02T09:35:26.770858,0,1323,1.0,1,11.6
2025-09-02T09:35:27.271140,0,1323,1.0,1,10.1
2025-09-02T09:35:27.771391,0,1323,1.0,1,6.7
2025-09-02T09:35:28.271612,0,1323,1.0,1,6.2
2025-09-02T09:35:28.771918,0,1323,1.0,1,4.5
2025-09-02T09:35:29.272250,0,1323,1.0,1,12.5
2025-09-02T09:35:29.772483,0,1323,1.0,1,7.5
2025-09-02T09:35:30.272734,0,1323,1.0,1,5.5
2025-09-02T09:35:30.772966,0,1323,1.0,1,5.9
2025-09-02T09:35:31.273205,0,1323,1.0,1,12.1
2025-09-02T09:35:31.773473,0,1323,1.0,1,9.8
2025-09-02T09:35:32.273727,0,1323,1.0,1,6.3
2025-09-02T09:35:32.773965,0,1323,1.0,1,4.3
2025-09-02T09:35:33.274207,0,1323,1.0,1,4.3
2025-09-02T09:35:33.774447,0,1323,1.0,1,7.1
2025-09-02T09:35:34.274693,0,1323,1.0,1,11.8
2025-09-02T09:35:34.774940,0,1323,1.0,1,9.2
2025-09-02T09:35:35.275203,0,1323,1.0,1,9.2
2025-09-02T09:35:35.775467,0,1323,1.0,1,8.6
2025-09-02T09:35:36.275710,0,1323,1.0,1,7.4
2025-09-02T09:35:36.775960,0,1323,1.0,1,11.6
2025-09-02T09:35:37.276210,0,1323,1.0,1,6.6
2025-09-02T09:35:37.776444,1,1324,1.0,1,11.9
2025-09-02T09:35:38.276773,0,1324,1.0,1,15.6
2025-09-02T09:35:38.777055,0,1324,1.0,1,10.8
2025-09-02T09:35:39.277381,0,1324,1.0,1,9.7
2025-09-02T09:35:39.777680,0,1324,1.0,1,13.3
2025-09-02T09:35:40.278028,1,1325,1.0,1,12.4
2025-09-02T09:35:40.778355,0,1325,1.0,1,9.4
2025-09-02T09:35:41.278736,0,1325,1.0,1,6.5
2025-09-02T09:35:41.779054,0,1325,1.0,1,14.6
2025-09-02T09:35:42.279428,0,1325,1.0,1,5.8
2025-09-02T09:35:42.779726,0,1325,1.0,1,7.3
2025-09-02T09:35:43.280051,0,1325,1.0,1,13.3
2025-09-02T09:35:43.780377,0,1325,1.0,1,7.7
2025-09-02T09:35:44.280629,0,1325,1.0,1,9.0
2025-09-02T09:35:44.780865,0,1325,1.0,1,10.9
2025-09-02T09:35:45.281219,0,1325,1.0,1,5.2
2025-09-02T09:35:45.781459,0,1325,1.0,1,14.3
2025-09-02T09:35:46.281739,0,1325,1.0,1,8.8
2025-09-02T09:35:46.781981,0,1325,1.0,1,5.5
2025-09-02T09:35:47.282214,0,1325,1.0,1,9.1
2025-09-02T09:35:47.782444,0,1325,1.0,1,11.7
2025-09-02T09:35:48.282687,0,1325,1.0,1,10.2
2025-09-02T09:35:48.782912,0,1325,1.0,1,8.1
2025-09-02T09:35:49.283137,0,1325,1.0,1,7.3
2025-09-02T09:35:49.783368,0,1325,1.0,1,14.4
2025-09-02T09:35:50.283592,5,1330,1.0,1,11.9
2025-09-02T09:35:50.783859,2,1332,1.0,1,9.7
2025-09-02T09:35:51.284143,1,1333,1.0,1,5.0
2025-09-02T09:35:51.784370,0,1333,1.0,1,4.6
2025-09-02T09:35:52.284591,0,1333,1.0,1,5.8
2025-09-02T09:35:52.784816,0,1333,1.0,1,4.3
2025-09-02T09:35:53.285040,0,1333,1.0,1,4.4
2025-09-02T09:35:53.785254,0,1333,1.0,1,4.3
2025-09-02T09:35:54.285490,0,1333,1.0,1,4.4
2025-09-02T09:35:54.785807,0,1333,1.0,1,4.3
2025-09-02T09:35:55.286032,0,1333,1.0,1,4.8
2025-09-02T09:35:55.786257,0,1333,1.0,1,7.0
2025-09-02T09:35:56.286572,0,1333,1.0,1,4.4
2025-09-02T09:35:56.786796,0,1333,1.0,1,4.5
2025-09-02T09:35:57.287031,0,1333,1.0,1,4.6
2025-09-02T09:35:57.787258,0,1333,1.0,1,15.8
2025-09-02T09:35:58.287532,0,1333,1.0,1,8.4
2025-09-02T09:35:58.787769,0,1333,1.0,1,6.2
2025-09-02T09:35:59.288011,1,1334,1.0,1,6.0
2025-09-02T09:35:59.788230,1,1335,1.0,1,8.1
2025-09-02T09:36:00.288482,0,1335,1.0,1,12.0
2025-09-02T09:36:00.788722,0,1335,1.0,1,8.0
2025-09-02T09:36:01.288962,0,1335,1.0,1,6.8
2025-09-02T09:36:01.789189,0,1335,1.0,1,9.6
2025-09-02T09:36:02.289414,0,1335,1.0,1,9.7
2025-09-02T09:36:02.789650,0,1335,1.0,1,11.6
2025-09-02T09:36:03.289894,0,1335,1.0,1,7.9
2025-09-02T09:36:03.790133,0,1335,1.0,1,6.5
2025-09-02T09:36:04.290367,0,1335,1.0,1,8.3
2025-09-02T09:36:04.790596,0,1335,1.0,1,4.4
2025-09-02T09:36:05.290838,0,1335,1.0,1,4.8
2025-09-02T09:36:05.791085,0,1335,1.0,1,7.0
2025-09-02T09:36:06.291330,0,1335,1.0,1,8.3
2025-09-02T09:36:06.791589,0,1335,1.0,1,6.2
2025-09-02T09:36:07.291836,0,1335,1.0,1,9.1
2025-09-02T09:36:07.792084,0,1335,1.0,1,5.8
2025-09-02T09:36:08.292311,0,1335,1.0,1,8.9
2025-09-02T09:36:08.792521,1,1336,1.0,1,5.6
2025-09-02T09:36:09.292752,1,1337,1.0,1,10.3
2025-09-02T09:36:09.792977,0,1337,1.0,1,6.0
2025-09-02T09:36:10.293188,0,1337,1.0,1,10.2
2025-09-02T09:36:10.793408,0,1337,1.0,1,6.0
2025-09-02T09:36:11.293635,0,1337,1.0,1,7.2
2025-09-02T09:36:11.793879,0,1337,1.0,1,6.0
2025-09-02T09:36:12.294163,0,1337,1.0,1,9.2
2025-09-02T09:36:12.794447,0,1337,1.0,1,5.3
2025-09-02T09:36:13.294707,0,1337,1.0,1,7.6
2025-09-02T09:36:13.794952,0,1337,1.0,1,11.6
2025-09-02T09:36:14.295181,0,1337,1.0,1,6.3
2025-09-02T09:36:14.795420,0,1337,1.0,1,9.5
2025-09-02T09:36:15.295649,0,1337,1.0,1,7.0
2025-09-02T09:36:15.795876,0,1337,1.0,1,5.5
2025-09-02T09:36:16.296182,0,1337,1.0,1,7.0
2025-09-02T09:36:16.796442,0,1337,1.0,1,7.7
2025-09-02T09:36:17.296661,0,1337,1.0,1,5.7
2025-09-02T09:36:17.796881,0,1337,1.0,1,5.4
2025-09-02T09:36:18.297099,0,1337,1.0,1,5.9
2025-09-02T09:36:18.797309,0,1337,1.0,1,7.5
2025-09-02T09:36:19.297536,0,1337,1.0,1,4.6
2025-09-02T09:36:19.797785,0,1337,1.0,1,11.6
2025-09-02T09:36:20.298024,0,1337,1.0,1,8.8
2025-09-02T09:36:20.798252,0,1337,1.0,1,8.5
2025-09-02T09:36:21.298528,0,1337,1.0,1,7.4
2025-09-02T09:36:21.798754,0,1337,1.0,1,4.5
2025-09-02T09:36:22.298983,0,1337,1.0,1,12.7
2025-09-02T09:36:22.799212,0,1337,1.0,1,9.2
2025-09-02T09:36:23.299448,0,1337,1.0,1,6.8
2025-09-02T09:36:23.799662,0,1337,1.0,1,4.9
2025-09-02T09:36:24.299880,0,1337,1.0,1,4.6
2025-09-02T09:36:24.800140,0,1337,1.0,1,6.6
2025-09-02T09:36:25.300360,0,1337,1.0,1,4.5
2025-09-02T09:36:25.800570,0,1337,1.0,1,4.4
2025-09-02T09:36:26.300849,0,1337,1.0,1,4.8
2025-09-02T09:36:26.801132,0,1337,1.0,1,7.1
2025-09-02T09:36:27.301404,0,1337,1.0,1,5.0
2025-09-02T09:36:27.801609,0,1337,1.0,1,4.0
2025-09-02T09:36:28.301824,0,1337,1.0,1,5.1
2025-09-02T09:36:28.802035,0,1337,1.0,1,4.6
2025-09-02T09:36:29.302248,0,1337,1.0,1,7.7
2025-09-02T09:36:29.802477,0,1337,1.0,1,4.9
2025-09-02T09:36:30.302690,0,1337,1.0,1,5.5
2025-09-02T09:36:30.802905,0,1337,1.0,1,5.4
2025-09-02T09:36:31.303124,0,1337,1.0,1,7.8
2025-09-02T09:36:31.803339,0,1337,1.0,1,5.0
2025-09-02T09:36:32.303615,0,1337,1.0,1,5.3
2025-09-02T09:36:32.803841,0,1337,1.0,1,5.3
2025-09-02T09:36:33.304068,0,1337,1.0,1,7.3
2025-09-02T09:36:33.804341,0,1337,1.0,1,5.5
2025-09-02T09:36:34.304522,0,1337,1.0,1,4.9
2025-09-02T09:36:34.804743,0,1337,1.0,1,5.5
2025-09-02T09:36:35.304952,0,1337,1.0,1,7.3
2025-09-02T09:36:35.805167,0,1337,1.0,1,5.8
2025-09-02T09:36:36.305438,0,1337,1.0,1,5.0
2025-09-02T09:36:36.805676,0,1337,1.0,1,5.6
2025-09-02T09:36:37.305894,0,1337,1.0,1,7.1
2025-09-02T09:36:37.806112,0,1337,1.0,1,5.6
2025-09-02T09:36:38.306325,0,1337,1.0,1,4.9
2025-09-02T09:36:38.806514,0,1337,1.0,1,4.4
2025-09-02T09:36:39.306720,0,1337,1.0,1,4.9
2025-09-02T09:36:39.806931,0,1337,1.0,1,7.9
2025-09-02T09:36:40.307149,0,1337,1.0,1,4.8
2025-09-02T09:36:40.807366,0,1337,1.0,1,5.9
2025-09-02T09:36:41.307590,0,1337,1.0,1,5.2
2025-09-02T09:36:41.807861,0,1337,1.0,1,8.0
2025-09-02T09:36:42.308132,0,1337,1.0,1,5.1
2025-09-02T09:36:42.808429,0,1337,1.0,1,5.5
2025-09-02T09:36:43.308658,0,1337,1.0,1,5.2
2025-09-02T09:36:43.808934,0,1337,1.0,1,7.1
2025-09-02T09:36:44.309204,0,1337,1.0,1,5.5
2025-09-02T09:36:44.809488,0,1337,1.0,1,5.0
2025-09-02T09:36:45.309701,0,1337,1.0,1,5.5
2025-09-02T09:36:45.809937,0,1337,1.0,1,7.1
2025-09-02T09:36:46.310168,0,1337,1.0,1,5.6
2025-09-02T09:36:46.810397,0,1337,1.0,1,5.0
2025-09-02T09:36:47.310611,0,1337,1.0,1,5.6
2025-09-02T09:36:47.810823,0,1337,1.0,1,7.2
2025-09-02T09:36:48.311059,0,1337,1.0,1,5.7
2025-09-02T09:36:48.811278,0,1337,1.0,1,4.9
2025-09-02T09:36:49.311475,0,1337,1.0,1,5.6
2025-09-02T09:36:49.811689,1,1338,1.0,1,7.6
2025-09-02T09:36:50.311934,0,1338,1.0,1,4.6
2025-09-02T09:36:50.812136,1,1339,1.0,1,4.1
2025-09-02T09:36:51.312378,0,1339,1.0,1,5.1
2025-09-02T09:36:51.812666,0,1339,1.0,1,11.8
2025-09-02T09:36:52.312890,0,1339,1.0,1,8.4
2025-09-02T09:36:52.813057,0,1339,1.0,1,7.0
2025-09-02T09:36:53.313274,0,1339,1.0,1,6.5
2025-09-02T09:36:53.813483,1,1340,1.0,1,11.3
2025-09-02T09:36:54.313689,0,1340,1.0,1,11.9
2025-09-02T09:36:54.813908,0,1340,1.0,1,5.7
2025-09-02T09:36:55.314128,0,1340,1.0,1,5.6
2025-09-02T09:36:55.814392,1,1341,1.0,1,10.4
2025-09-02T09:36:56.314628,0,1341,1.0,1,11.8
2025-09-02T09:36:56.814847,0,1341,1.0,1,7.5
2025-09-02T09:36:57.315063,0,1341,1.0,1,8.2
2025-09-02T09:36:57.815276,0,1341,1.0,1,5.1
2025-09-02T09:36:58.315472,0,1341,1.0,1,6.9
2025-09-02T09:36:58.815684,0,1341,1.0,1,4.3
2025-09-02T09:36:59.315906,0,1341,1.0,1,11.4
2025-09-02T09:36:59.816178,0,1341,1.0,1,6.8
2025-09-02T09:37:00.316424,0,1341,1.0,1,10.5
2025-09-02T09:37:00.816646,0,1341,1.0,1,11.5
2025-09-02T09:37:01.316873,0,1341,1.0,1,9.2
2025-09-02T09:37:01.817094,0,1341,1.0,1,11.4
2025-09-02T09:37:02.317317,0,1341,1.0,1,8.3
2025-09-02T09:37:02.817538,0,1341,1.0,1,8.0
2025-09-02T09:37:03.317754,0,1341,1.0,1,5.8
2025-09-02T09:37:03.818015,4,1345,1.0,1,7.2
2025-09-02T09:37:04.318407,4,1349,1.0,1,10.4
2025-09-02T09:37:04.818669,0,1349,1.0,1,8.5
2025-09-02T09:37:05.318959,0,1349,1.0,1,9.2
2025-09-02T09:37:05.819155,0,1349,1.0,1,4.8
2025-09-02T09:37:06.319381,0,1349,1.0,1,6.6
2025-09-02T09:37:06.819601,0,1349,1.0,1,5.1
2025-09-02T09:37:07.319826,0,1349,1.0,1,4.1
2025-09-02T09:37:07.820123,0,1349,1.0,1,3.9
2025-09-02T09:37:08.320349,0,1349,1.0,1,6.4
2025-09-02T09:37:08.820535,0,1349,1.0,1,4.2
2025-09-02T09:37:09.320761,0,1349,1.0,1,4.4
2025-09-02T09:37:09.821042,0,1349,1.0,1,4.0
2025-09-02T09:37:10.321268,0,1349,1.0,1,8.8
2025-09-02T09:37:10.821467,0,1349,1.0,1,14.3
2025-09-02T09:37:11.321702,1,1350,1.0,1,8.6
2025-09-02T09:37:11.821921,0,1350,1.0,1,7.0
2025-09-02T09:37:12.322147,0,1350,1.0,1,6.4
2025-09-02T09:37:12.822379,0,1350,1.0,1,13.1
2025-09-02T09:37:13.322608,0,1350,1.0,1,7.4
2025-09-02T09:37:13.822838,0,1350,1.0,1,5.6
2025-09-02T09:37:14.323064,0,1350,1.0,1,7.0
2025-09-02T09:37:14.823296,0,1350,1.0,1,13.0
2025-09-02T09:37:15.323494,0,1350,1.0,1,6.2
2025-09-02T09:37:15.823730,0,1350,1.0,1,7.2
2025-09-02T09:37:16.323971,0,1350,1.0,1,11.9
2025-09-02T09:37:16.824253,0,1350,1.0,1,9.8
2025-09-02T09:37:17.324488,0,1350,1.0,1,12.8
2025-09-02T09:37:17.824720,0,1350,1.0,1,6.4
2025-09-02T09:37:18.324951,0,1350,1.0,1,7.5
2025-09-02T09:37:18.825170,0,1350,1.0,1,6.1
2025-09-02T09:37:19.325409,0,1350,1.0,1,4.9
2025-09-02T09:37:19.825624,0,1350,1.0,1,4.6
2025-09-02T09:37:20.325918,0,1350,1.0,1,4.6
2025-09-02T09:37:20.826118,0,1350,1.0,1,6.7
2025-09-02T09:37:21.326393,0,1350,1.0,1,5.0
2025-09-02T09:37:21.826610,0,1350,1.0,1,4.3
2025-09-02T09:37:22.326833,0,1350,1.0,1,3.9
2025-09-02T09:37:22.827054,0,1350,1.0,1,6.7
2025-09-02T09:37:23.327284,0,1350,1.0,1,4.3
2025-09-02T09:37:23.827468,0,1350,1.0,1,4.2
2025-09-02T09:37:24.327771,0,1350,1.0,1,3.8
2025-09-02T09:37:24.827994,0,1350,1.0,1,4.3
2025-09-02T09:37:25.328218,0,1350,1.0,1,6.5
2025-09-02T09:37:25.828441,0,1350,1.0,1,4.4
2025-09-02T09:37:26.328661,0,1350,1.0,1,3.9
2025-09-02T09:37:26.828881,0,1350,1.0,1,4.4
2025-09-02T09:37:27.329103,0,1350,1.0,1,6.1
2025-09-02T09:37:27.829319,0,1350,1.0,1,4.8
2025-09-02T09:37:28.329553,0,1350,1.0,1,4.3
2025-09-02T09:37:28.829773,0,1350,1.0,1,4.2
2025-09-02T09:37:29.330006,0,1350,1.0,1,6.7
2025-09-02T09:37:29.830228,0,1350,1.0,1,5.3
2025-09-02T09:37:30.330455,0,1350,1.0,1,4.2
2025-09-02T09:37:30.830685,0,1350,1.0,1,4.3
2025-09-02T09:37:31.330921,0,1350,1.0,1,7.8
2025-09-02T09:37:31.831119,0,1350,1.0,1,5.1
2025-09-02T09:37:32.331341,0,1350,1.0,1,5.8
2025-09-02T09:37:32.831555,0,1350,1.0,1,5.1
2025-09-02T09:37:33.331866,0,1350,1.0,1,8.0
2025-09-02T09:37:33.832177,0,1350,1.0,1,5.1
2025-09-02T09:37:34.332533,0,1350,1.0,1,5.8
2025-09-02T09:37:34.832914,0,1350,1.0,1,3.8
2025-09-02T09:37:35.333283,0,1350,1.0,1,4.3
2025-09-02T09:37:35.833619,0,1350,1.0,1,7.0
2025-09-02T09:37:36.333915,0,1350,1.0,1,4.3
2025-09-02T09:37:36.834234,0,1350,1.0,1,4.1
2025-09-02T09:37:37.334563,0,1350,1.0,1,9.4
2025-09-02T09:37:37.834850,0,1350,1.0,1,13.4
2025-09-02T09:37:38.335156,0,1350,1.0,1,5.9
2025-09-02T09:37:38.835455,0,1350,1.0,1,9.9
2025-09-02T09:37:39.335752,0,1350,1.0,1,9.0
2025-09-02T09:37:39.836041,0,1350,1.0,1,8.0
2025-09-02T09:37:40.336344,0,1350,1.0,1,6.4
2025-09-02T09:37:40.836601,0,1350,1.0,1,4.6
2025-09-02T09:37:41.336909,0,1350,1.0,1,4.3
2025-09-02T09:37:41.837240,0,1350,1.0,1,6.9
2025-09-02T09:37:42.337596,0,1350,1.0,1,5.8
2025-09-02T09:37:42.837879,0,1350,1.0,1,4.1
2025-09-02T09:37:43.338245,0,1350,1.0,1,4.3
2025-09-02T09:37:43.838527,0,1350,1.0,1,6.9
2025-09-02T09:37:44.338826,0,1350,1.0,1,5.5
2025-09-02T09:37:44.839113,0,1350,1.0,1,5.3
2025-09-02T09:37:45.339500,0,1350,1.0,1,5.5
2025-09-02T09:37:45.839770,0,1350,1.0,1,7.4
2025-09-02T09:37:46.340060,0,1350,1.0,1,5.1
2025-09-02T09:37:46.840353,0,1350,1.0,1,4.5
2025-09-02T09:37:47.340711,0,1350,1.0,1,5.2
2025-09-02T09:37:47.841119,0,1350,1.0,1,6.8
2025-09-02T09:37:48.341431,0,1350,1.0,1,3.8
2025-09-02T09:37:48.841710,0,1350,1.0,1,4.3
2025-09-02T09:37:49.342001,0,1350,1.0,1,4.5
2025-09-02T09:37:49.842313,0,1350,1.0,1,7.9
2025-09-02T09:37:50.342628,0,1350,1.0,1,5.4
2025-09-02T09:37:50.842888,0,1350,1.0,1,5.8
2025-09-02T09:37:51.343216,0,1350,1.0,1,5.3
2025-09-02T09:37:51.843504,0,1350,1.0,1,6.0
2025-09-02T09:37:52.343791,0,1350,1.0,1,4.8
2025-09-02T09:37:52.844103,0,1350,1.0,1,4.4
2025-09-02T09:37:53.344452,0,1350,1.0,1,4.3
2025-09-02T09:37:53.844736,0,1350,1.0,1,4.3
2025-09-02T09:37:54.345067,0,1350,1.0,1,4.3
2025-09-02T09:37:54.845398,0,1350,1.0,1,4.5
2025-09-02T09:37:55.345698,0,1350,1.0,1,5.3
2025-09-02T09:37:55.845956,0,1350,1.0,1,8.2
2025-09-02T09:37:56.346271,0,1350,1.0,1,4.2
2025-09-02T09:37:56.846564,0,1350,1.0,1,4.5
2025-09-02T09:37:57.346859,0,1350,1.0,1,4.1
2025-09-02T09:37:57.847145,0,1350,1.0,1,7.3
2025-09-02T09:37:58.347447,0,1350,1.0,1,4.4
2025-09-02T09:37:58.847725,0,1350,1.0,1,4.2
2025-09-02T09:37:59.348013,0,1350,1.0,1,4.3
2025-09-02T09:37:59.848387,0,1350,1.0,1,6.9
2025-09-02T09:38:00.348683,0,1350,1.0,1,4.5
2025-09-02T09:38:00.848948,0,1350,1.0,1,4.4
2025-09-02T09:38:01.349249,0,1350,1.0,1,4.5
2025-09-02T09:38:01.849552,0,1350,1.0,1,6.6
2025-09-02T09:38:02.349836,0,1350,1.0,1,6.1
2025-09-02T09:38:02.850188,0,1350,1.0,1,5.2
2025-09-02T09:38:03.350525,0,1350,1.0,1,4.4
2025-09-02T09:38:03.850798,0,1350,1.0,1,6.6
2025-09-02T09:38:04.351094,0,1350,1.0,1,5.8
2025-09-02T09:38:04.851489,0,1350,1.0,1,4.0
2025-09-02T09:38:05.351793,0,1350,1.0,1,4.1
2025-09-02T09:38:05.852113,0,1350,1.0,1,4.6
2025-09-02T09:38:06.352468,2,1352,1.0,1,6.3
2025-09-02T09:38:06.852728,0,1352,1.0,1,4.1
2025-09-02T09:38:07.353079,1,1353,1.0,1,7.4
2025-09-02T09:38:07.853387,0,1353,1.0,1,7.0
2025-09-02T09:38:08.353675,0,1353,1.0,1,6.7
2025-09-02T09:38:08.854023,1,1354,1.0,1,4.9
2025-09-02T09:38:09.354339,0,1354,1.0,1,5.0
2025-09-02T09:38:09.854649,0,1354,1.0,1,4.7
2025-09-02T09:38:10.354947,0,1354,1.0,1,6.6
2025-09-02T09:38:10.855243,0,1354,1.0,1,4.1
2025-09-02T09:38:11.355542,0,1354,1.0,1,4.6
2025-09-02T09:38:11.855838,0,1354,1.0,1,4.1
2025-09-02T09:38:12.356140,0,1354,1.0,1,6.5
2025-09-02T09:38:12.856448,0,1354,1.0,1,4.5
2025-09-02T09:38:13.356749,0,1354,1.0,1,4.1
2025-09-02T09:38:13.857055,0,1354,1.0,1,3.9
2025-09-02T09:38:14.357367,0,1354,1.0,1,6.5
2025-09-02T09:38:14.857660,0,1354,1.0,1,4.1
2025-09-02T09:38:15.357958,0,1354,1.0,1,4.2
2025-09-02T09:38:15.858858,0,1354,1.0,1,2.2
2025-09-02T09:38:16.359710,0,1354,1.0,1,0.7
2025-09-02T09:38:16.860176,0,1354,1.0,1,1.8
2025-09-02T09:38:17.360874,0,1354,1.0,1,0.8
2025-09-02T09:38:17.861609,0,1354,1.0,1,0.4
2025-09-02T09:38:18.362324,0,1354,1.0,1,0.5
2025-09-02T09:38:18.862945,0,1354,1.0,1,0.3
2025-09-02T09:38:19.363641,0,1354,1.0,1,0.9
2025-09-02T09:38:19.864231,0,1354,1.0,1,1.7
2025-09-02T09:38:20.364514,0,1354,1.0,1,8.3
2025-09-02T09:38:20.865056,0,1354,1.0,1,4.9
2025-09-02T09:38:21.365731,0,1354,1.0,1,3.6
2025-09-02T09:38:21.866067,0,1354,1.0,1,3.8
2025-09-02T09:38:22.366734,0,1354,1.0,1,1.7
2025-09-02T09:38:22.867366,0,1354,1.0,1,0.5
2025-09-02T09:38:23.367952,0,1354,1.0,1,0.8
2025-09-02T09:38:23.868638,0,1354,1.0,1,0.4
2025-09-02T09:38:24.369271,0,1354,1.0,1,1.8
2025-09-02T09:38:24.869700,0,1354,1.0,1,1.0
2025-09-02T09:38:25.370266,0,1354,1.0,1,0.7
2025-09-02T09:38:25.870855,0,1354,1.0,1,0.4
2025-09-02T09:38:26.371640,0,1354,1.0,1,0.5
2025-09-02T09:38:26.872234,0,1354,1.0,1,0.4
2025-09-02T09:38:27.372922,0,1354,1.0,1,0.4
2025-09-02T09:38:27.873712,0,1354,1.0,1,0.6
2025-09-02T09:38:28.374050,0,1354,1.0,1,5.8
2025-09-02T09:38:28.874314,0,1354,1.0,1,6.6
2025-09-02T09:38:29.374812,0,1354,1.0,1,4.3
2025-09-02T09:38:29.875109,0,1354,1.0,1,4.1
2025-09-02T09:38:30.375773,0,1354,1.0,1,3.1
2025-09-02T09:38:30.876395,0,1354,1.0,1,0.8
2025-09-02T09:38:31.376682,0,1354,1.0,1,8.2
2025-09-02T09:38:31.877223,0,1354,1.0,1,2.9
2025-09-02T09:38:32.378087,0,1354,1.0,1,3.2
2025-09-02T09:38:32.879082,0,1354,1.0,1,1.1
2025-09-02T09:38:33.380140,0,1354,1.0,1,1.3
2025-09-02T09:38:33.880565,0,1354,1.0,1,7.5
2025-09-02T09:38:34.381462,0,1354,1.0,1,3.6
2025-09-02T09:38:34.881865,0,1354,1.0,1,4.4
2025-09-02T09:38:35.382200,0,1354,1.0,1,6.9
2025-09-02T09:38:35.883105,0,1354,1.0,1,2.1
2025-09-02T09:38:36.384083,0,1354,1.0,1,3.9
2025-09-02T09:38:36.884668,0,1354,1.0,1,0.8
2025-09-02T09:38:37.385025,0,1354,1.0,1,7.3
2025-09-02T09:38:37.885970,0,1354,1.0,1,2.9
2025-09-02T09:38:38.386456,0,1354,1.0,1,2.3
2025-09-02T09:38:38.887007,0,1354,1.0,1,2.6
2025-09-02T09:38:39.387742,0,1354,1.0,1,0.5
2025-09-02T09:38:39.888327,0,1354,1.0,1,1.3
2025-09-02T09:38:40.388990,0,1354,1.0,1,0.4
2025-09-02T09:38:40.889578,0,1354,1.0,1,1.6
2025-09-02T09:38:41.390153,0,1354,1.0,1,0.4
2025-09-02T09:38:41.890775,0,1354,1.0,1,1.3
2025-09-02T09:38:42.391525,0,1354,1.0,1,0.4
2025-09-02T09:38:42.892099,0,1354,1.0,1,0.4
2025-09-02T09:38:43.392856,0,1354,1.0,1,0.4
2025-09-02T09:38:43.893634,0,1354,1.0,1,0.4
2025-09-02T09:38:44.394226,0,1354,1.0,1,0.4
2025-09-02T09:38:44.894955,0,1354,1.0,1,1.3
2025-09-02T09:38:45.395253,0,1354,1.0,1,6.7
2025-09-02T09:38:45.895909,0,1354,1.0,1,3.8
2025-09-02T09:38:46.396191,0,1354,1.0,1,4.8
2025-09-02T09:38:46.896667,0,1354,1.0,1,5.4
2025-09-02T09:38:47.397138,0,1354,1.0,1,1.7
2025-09-02T09:38:47.897753,0,1354,1.0,1,2.5
2025-09-02T09:38:48.398048,0,1354,1.0,1,1.2
2025-09-02T09:38:48.898697,0,1354,1.0,1,3.5
2025-09-02T09:38:49.399005,0,1354,1.0,1,5.2
2025-09-02T09:38:49.899516,0,1354,1.0,1,3.6
2025-09-02T09:38:50.399829,0,1354,1.0,1,2.9
2025-09-02T09:38:50.900317,0,1354,1.0,1,3.8
2025-09-02T09:38:51.400904,0,1354,1.0,1,3.0
2025-09-02T09:38:51.901187,0,1354,1.0,1,2.8
2025-09-02T09:38:52.401716,0,1354,1.0,1,4.0
2025-09-02T09:38:52.902256,0,1354,1.0,1,2.8
2025-09-02T09:38:53.402588,0,1354,1.0,1,3.9
2025-09-02T09:38:53.902826,0,1354,1.0,1,4.6
2025-09-02T09:38:54.403114,0,1354,1.0,1,1.6
2025-09-02T09:38:54.903659,0,1354,1.0,1,2.9
2025-09-02T09:38:55.404220,0,1354,1.0,1,3.4
2025-09-02T09:38:55.904746,0,1354,1.0,1,2.1
2025-09-02T09:38:56.405292,0,1354,1.0,1,2.6
2025-09-02T09:38:56.905887,0,1354,1.0,1,2.9
2025-09-02T09:38:57.406519,0,1354,1.0,1,3.7
2025-09-02T09:38:57.907046,0,1354,1.0,1,4.5
2025-09-02T09:38:58.407574,0,1354,1.0,1,0.5
2025-09-02T09:38:58.907890,0,1354,1.0,1,2.5
2025-09-02T09:38:59.408513,0,1354,1.0,1,1.2
2025-09-02T09:38:59.909052,0,1354,1.0,1,2.9
2025-09-02T09:39:00.410013,0,1354,1.0,1,6.7
2025-09-02T09:39:00.910749,0,1354,1.0,1,1.4
