timestamp,interval_count,total_count,queue_size,max_queue_size,cpu_percent
2025-08-18T11:29:48.951813,10,10,1.3,2,0.0
2025-08-18T11:29:49.452173,40,50,3.175,10,5.7
2025-08-18T11:29:49.952531,37,87,2.5675675675675675,10,5.9
2025-08-18T11:29:50.453055,90,177,3.466666666666667,10,6.3
2025-08-18T11:29:50.953375,64,241,3.5,10,5.8
2025-08-18T11:29:51.453713,61,302,4.442622950819672,10,5.9
2025-08-18T11:29:51.954068,68,370,3.8088235294117645,10,6.8
2025-08-18T11:29:52.454428,77,447,3.5844155844155843,10,6.1
2025-08-18T11:29:52.954769,63,510,3.492063492063492,10,5.8
2025-08-18T11:29:53.455107,64,574,2.671875,10,5.2
2025-08-18T11:29:53.955446,69,643,2.753623188405797,10,5.6
2025-08-18T11:29:54.455940,78,721,3.1923076923076925,10,7.0
2025-08-18T11:29:54.956301,38,759,3.6315789473684212,10,5.3
2025-08-18T11:29:55.456666,72,831,4.319444444444445,10,5.9
2025-08-18T11:29:55.957020,43,874,4.1395348837209305,10,5.1
2025-08-18T11:29:56.463199,42,916,4.088235294117647,10,5.0
2025-08-18T11:29:56.963561,62,978,3.257142857142857,10,5.8
2025-08-18T11:29:57.463769,62,1040,2.9193548387096775,10,5.5
2025-08-18T11:29:57.963976,38,1078,4.7105263157894735,10,8.9
2025-08-18T11:29:58.464201,42,1120,4.619047619047619,10,7.1
2025-08-18T11:29:58.964458,33,1153,3.5454545454545454,10,5.5
2025-08-18T11:29:59.464702,36,1189,2.3055555555555554,10,5.0
2025-08-18T11:29:59.964901,40,1229,3.3,10,5.9
2025-08-18T11:30:00.465114,50,1279,3.78,10,4.7
2025-08-18T11:30:00.965324,79,1358,4.379746835443038,10,6.1
2025-08-18T11:30:01.465536,52,1410,3.3653846153846154,10,7.1
2025-08-18T11:30:01.965780,19,1429,4.2105263157894735,10,4.7
2025-08-18T11:30:02.466012,40,1469,3.85,10,4.4
2025-08-18T11:30:02.966223,46,1515,3.8260869565217392,10,6.9
2025-08-18T11:30:03.466441,32,1547,5.25,10,4.8
2025-08-18T11:30:03.966716,48,1595,3.2708333333333335,10,4.6
2025-08-18T11:30:04.466965,41,1636,3.6341463414634148,10,4.6
2025-08-18T11:30:04.967191,19,1655,1.105263157894737,10,5.0
2025-08-18T11:30:05.467416,0,1655,1.0,10,3.3
2025-08-18T11:30:05.967686,0,1655,1.0,10,3.7
2025-08-18T11:30:06.468029,0,1655,1.0,10,3.6
2025-08-18T11:30:06.968323,0,1655,1.0,10,3.4
2025-08-18T11:30:07.468563,8,1663,2.25,10,4.5
2025-08-18T11:30:07.975062,10,1673,1.2,10,5.1
2025-08-18T11:30:08.475421,0,1673,1.4,10,3.3
2025-08-18T11:30:08.975795,1,1674,1.0,10,3.8
2025-08-18T11:30:09.476208,10,1684,5.5,10,5.1
2025-08-18T11:30:09.976581,10,1694,5.5,10,6.2
2025-08-18T11:30:10.476941,7,1701,4.0,10,4.3
2025-08-18T11:30:10.977237,0,1701,7.0,10,3.4
2025-08-18T11:30:11.477658,10,1711,1.3,10,3.6
2025-08-18T11:30:11.977922,0,1711,1.0,10,3.9
2025-08-18T11:30:12.481023,13,1724,3.230769230769231,10,4.9
2025-08-18T11:30:12.981357,6,1730,3.5,10,4.8
2025-08-18T11:30:13.481667,10,1740,5.5,10,3.4
2025-08-18T11:30:13.981943,7,1747,4.0,10,6.4
2025-08-18T11:30:14.482237,10,1757,5.5,10,3.4
2025-08-18T11:30:14.982505,39,1796,4.743589743589744,10,7.1
2025-08-18T11:30:15.482687,0,1796,10.0,10,3.3
2025-08-18T11:30:15.982986,13,1809,4.6923076923076925,10,6.0
2025-08-18T11:30:16.483258,10,1819,5.5,10,3.7
2025-08-18T11:30:16.983518,5,1824,3.0,10,4.4
2025-08-18T11:30:17.483783,10,1834,2.0,10,4.9
2025-08-18T11:30:17.984002,0,1834,1.0,10,3.4
2025-08-18T11:30:18.484243,0,1834,1.0,10,3.4
2025-08-18T11:30:19.090250,7,1841,2.5,10,4.1
2025-08-18T11:30:19.590521,0,1841,1.3333333333333333,10,6.6
2025-08-18T11:30:20.090817,10,1851,1.4,10,3.9
2025-08-18T11:30:20.591032,0,1851,3.0,10,3.3
2025-08-18T11:30:21.091241,0,1851,3.0,10,3.4
2025-08-18T11:30:21.591549,0,1851,3.0,10,3.3
2025-08-18T11:30:22.091805,0,1851,3.0,10,3.4
2025-08-18T11:30:22.592033,9,1860,3.4444444444444446,10,3.8
2025-08-18T11:30:23.092242,10,1870,5.5,10,6.5
2025-08-18T11:30:23.592569,0,1870,10.0,10,3.3
2025-08-18T11:30:24.092777,0,1870,10.0,10,3.7
2025-08-18T11:30:24.592996,5,1875,1.4,10,6.6
2025-08-18T11:30:25.093258,0,1875,2.0,10,3.8
2025-08-18T11:30:25.593586,0,1875,2.0,10,3.6
2025-08-18T11:30:26.093919,10,1885,1.4,10,3.7
2025-08-18T11:30:26.594239,3,1888,1.3333333333333333,10,4.9
2025-08-18T11:30:27.094505,10,1898,5.5,10,4.0
2025-08-18T11:30:27.594775,0,1898,10.0,10,3.4
2025-08-18T11:30:28.095079,28,1926,4.178571428571429,10,6.3
2025-08-18T11:30:28.595338,10,1936,4.6,10,3.4
2025-08-18T11:30:29.095656,8,1944,3.625,10,5.7
2025-08-18T11:30:29.595942,10,1954,5.5,10,3.7
2025-08-18T11:30:30.096198,10,1964,3.1,10,4.4
2025-08-18T11:30:30.596449,10,1974,2.6,10,3.9
2025-08-18T11:30:31.096715,19,1993,4.842105263157895,10,4.8
2025-08-18T11:30:31.596946,0,1993,10.0,10,3.3
2025-08-18T11:30:32.097221,12,2005,4.083333333333333,10,5.8
2025-08-18T11:30:32.597546,3,2008,2.0,10,3.9
2025-08-18T11:30:33.097903,10,2018,5.5,10,5.5
2025-08-18T11:30:33.598208,0,2018,10.0,10,3.4
2025-08-18T11:30:34.098595,0,2018,10.0,10,3.4
2025-08-18T11:30:34.598878,11,2029,3.5454545454545454,10,3.9
2025-08-18T11:30:35.099234,10,2039,5.5,10,4.8
2025-08-18T11:30:35.599539,35,2074,4.771428571428571,10,4.9
2025-08-18T11:30:36.099899,69,2143,3.028985507246377,10,5.8
2025-08-18T11:30:36.600215,10,2153,3.8,10,3.6
2025-08-18T11:30:37.100645,36,2189,4.861111111111111,10,5.1
2025-08-18T11:30:37.601005,20,2209,5.5,10,4.0
2025-08-18T11:30:38.101372,21,2230,4.142857142857143,10,5.9
2025-08-18T11:30:38.601855,22,2252,5.136363636363637,10,4.0
2025-08-18T11:30:39.102221,10,2262,5.5,10,4.1
2025-08-18T11:30:39.602610,14,2276,2.5714285714285716,10,6.0
2025-08-18T11:30:40.102919,0,2276,6.0,10,3.5
2025-08-18T11:30:40.603224,15,2291,4.666666666666667,10,6.2
2025-08-18T11:30:41.103594,0,2291,10.0,10,3.4
2025-08-18T11:30:41.603977,17,2308,3.8823529411764706,10,4.8
2025-08-18T11:30:42.104343,10,2318,5.5,10,3.4
2025-08-18T11:30:42.604740,0,2318,10.0,10,3.6
2025-08-18T11:30:43.105066,10,2328,5.5,10,3.9
2025-08-18T11:30:43.605354,10,2338,5.5,10,5.3
2025-08-18T11:30:44.105717,0,2338,10.0,10,3.4
2025-08-18T11:30:44.605986,3,2341,2.0,10,4.1
2025-08-18T11:30:45.106215,10,2351,4.6,10,6.6
2025-08-18T11:30:45.606520,10,2361,5.5,10,3.7
2025-08-18T11:30:46.106760,0,2361,10.0,10,4.7
2025-08-18T11:30:46.606995,5,2366,3.0,10,3.6
2025-08-18T11:30:47.107263,10,2376,5.5,10,4.2
2025-08-18T11:30:47.607563,0,2376,10.0,10,3.6
2025-08-18T11:30:48.107879,12,2388,4.75,10,5.5
2025-08-18T11:30:48.608257,0,2388,10.0,10,5.8
2025-08-18T11:30:49.108576,6,2394,2.6666666666666665,10,4.3
2025-08-18T11:30:49.608881,10,2404,3.8,10,8.0
2025-08-18T11:30:50.109203,0,2404,8.0,10,3.7
2025-08-18T11:30:50.609659,10,2414,4.6,10,4.3
2025-08-18T11:30:51.109898,10,2424,5.5,10,3.6
2025-08-18T11:30:51.610119,0,2424,10.0,10,3.6
2025-08-18T11:30:52.110420,0,2424,10.0,10,3.6
2025-08-18T11:30:52.610696,0,2424,10.0,10,3.5
2025-08-18T11:30:53.110916,13,2437,1.9230769230769231,10,4.6
2025-08-18T11:30:53.611140,10,2447,2.6,10,3.7
2025-08-18T11:30:54.111373,0,2447,5.0,10,3.5
2025-08-18T11:30:54.611647,0,2447,5.0,10,3.7
2025-08-18T11:30:55.111876,0,2447,5.0,10,3.7
2025-08-18T11:30:55.612105,0,2447,5.0,10,3.4
2025-08-18T11:30:56.112381,0,2447,5.0,10,3.4
2025-08-18T11:30:56.612612,0,2447,5.0,10,3.5
2025-08-18T11:30:57.112846,10,2457,3.9,10,6.6
2025-08-18T11:30:57.613069,10,2467,2.5,10,3.4
2025-08-18T11:30:58.113308,0,2467,1.0,10,4.2
2025-08-18T11:30:58.613544,0,2467,1.0,10,3.4
2025-08-18T11:30:59.113860,0,2467,1.0,10,3.4
2025-08-18T11:30:59.614208,1,2468,1.0,10,3.7
2025-08-18T11:31:00.114606,0,2468,1.0,10,3.7
2025-08-18T11:31:00.614903,10,2478,3.4,10,4.6
2025-08-18T11:31:01.115236,0,2478,3.0,10,3.4
2025-08-18T11:31:01.615623,10,2488,1.4,10,3.4
2025-08-18T11:31:02.115933,0,2488,3.0,10,3.6
2025-08-18T11:31:02.616302,0,2488,3.0,10,3.4
2025-08-18T11:31:03.116780,0,2488,3.0,10,4.7
2025-08-18T11:31:03.617000,0,2488,3.0,10,3.4
2025-08-18T11:31:04.117233,3,2491,1.3333333333333333,10,3.8
2025-08-18T11:31:04.617459,10,2501,1.3,10,4.9
2025-08-18T11:31:05.117702,0,2501,3.0,10,3.5
2025-08-18T11:31:05.617975,0,2501,3.0,10,3.5
2025-08-18T11:31:06.118192,0,2501,3.0,10,3.4
2025-08-18T11:31:06.618482,0,2501,3.0,10,3.7
2025-08-18T11:31:07.118723,0,2501,3.0,10,3.3
2025-08-18T11:31:07.618942,0,2501,3.0,10,3.4
2025-08-18T11:31:08.119155,6,2507,3.5,10,4.6
2025-08-18T11:31:08.619408,10,2517,5.5,10,3.6
2025-08-18T11:31:09.119652,0,2517,10.0,10,3.4
2025-08-18T11:31:09.619882,0,2517,10.0,10,4.0
2025-08-18T11:31:10.120143,0,2517,10.0,10,3.4
2025-08-18T11:31:10.620362,0,2517,10.0,10,3.4
2025-08-18T11:31:11.120610,0,2517,10.0,10,3.4
2025-08-18T11:31:11.620827,0,2517,10.0,10,3.4
2025-08-18T11:31:12.121039,8,2525,4.5,10,6.6
2025-08-18T11:31:12.621423,10,2535,5.5,10,4.0
2025-08-18T11:31:13.121649,0,2535,10.0,10,3.4
2025-08-18T11:31:13.621856,0,2535,10.0,10,3.5
2025-08-18T11:31:14.122074,0,2535,10.0,10,3.4
2025-08-18T11:31:14.622357,0,2535,10.0,10,3.6
2025-08-18T11:31:15.122616,0,2535,10.0,10,3.4
2025-08-18T11:31:15.622876,0,2535,10.0,10,3.4
2025-08-18T11:31:16.123147,8,2543,1.125,10,4.7
2025-08-18T11:31:16.666441,10,2553,2.0,10,4.6
2025-08-18T11:31:17.167213,0,2553,2.5714285714285716,10,3.6
2025-08-18T11:31:17.667485,0,2553,5.0,10,3.5
2025-08-18T11:31:18.167722,0,2553,5.0,10,3.4
2025-08-18T11:31:18.667975,0,2553,5.0,10,3.4
2025-08-18T11:31:19.168210,0,2553,5.0,10,3.6
2025-08-18T11:31:19.668456,0,2553,5.0,10,3.4
2025-08-18T11:31:20.168690,1,2554,1.0,10,4.8
2025-08-18T11:31:20.668907,10,2564,3.8,10,4.3
2025-08-18T11:31:21.169137,0,2564,1.0,10,3.3
2025-08-18T11:31:21.669385,0,2564,1.0,10,3.6
2025-08-18T11:31:22.169703,0,2564,1.0,10,4.6
2025-08-18T11:31:22.669926,0,2564,1.0,10,3.4
2025-08-18T11:31:23.170198,0,2564,1.0,10,3.6
2025-08-18T11:31:23.670423,0,2564,1.0,10,3.3
2025-08-18T11:31:24.170674,0,2564,1.0,10,3.5
2025-08-18T11:31:24.670891,0,2564,1.0,10,3.5
2025-08-18T11:31:25.171111,7,2571,2.5714285714285716,10,4.3
2025-08-18T11:31:25.671457,0,2571,5.0,10,6.9
2025-08-18T11:31:26.171722,10,2581,5.5,10,3.9
2025-08-18T11:31:26.672018,0,2581,10.0,10,3.4
2025-08-18T11:31:27.172410,0,2581,10.0,10,3.7
2025-08-18T11:31:27.672783,0,2581,10.0,10,3.6
2025-08-18T11:31:28.173092,0,2581,10.0,10,3.6
2025-08-18T11:31:28.673486,0,2581,10.0,10,3.4
2025-08-18T11:31:29.173755,0,2581,10.0,10,3.2
2025-08-18T11:31:29.673981,0,2581,10.0,10,3.6
2025-08-18T11:31:30.174210,0,2581,10.0,10,3.4
2025-08-18T11:31:30.674480,0,2581,10.0,10,3.6
2025-08-18T11:31:31.174709,0,2581,10.0,10,3.4
2025-08-18T11:31:31.674915,6,2587,3.5,10,4.8
2025-08-18T11:31:32.175176,0,2587,6.0,10,3.4
2025-08-18T11:31:32.675396,0,2587,6.0,10,3.4
2025-08-18T11:31:33.175630,10,2597,5.5,10,3.9
2025-08-18T11:31:33.675850,0,2597,10.0,10,3.5
2025-08-18T11:31:34.176108,0,2597,10.0,10,3.4
2025-08-18T11:31:34.676333,0,2597,10.0,10,3.8
2025-08-18T11:31:35.176611,0,2597,10.0,10,3.4
2025-08-18T11:31:35.676840,0,2597,10.0,10,3.6
2025-08-18T11:31:36.177084,0,2597,10.0,10,3.5
2025-08-18T11:31:36.677306,0,2597,10.0,10,3.4
2025-08-18T11:31:37.177537,0,2597,10.0,10,3.4
2025-08-18T11:31:37.677773,0,2597,10.0,10,3.5
2025-08-18T11:31:38.178046,0,2597,10.0,10,3.3
2025-08-18T11:31:38.678264,7,2604,1.4285714285714286,10,5.6
2025-08-18T11:31:39.178595,20,2624,1.85,10,7.2
2025-08-18T11:31:39.678892,14,2638,2.642857142857143,10,4.8
2025-08-18T11:31:40.179261,39,2677,2.8205128205128207,10,4.8
2025-08-18T11:31:40.679689,13,2690,4.6923076923076925,10,4.3
2025-08-18T11:31:41.179960,37,2727,3.081081081081081,10,5.0
2025-08-18T11:31:41.680236,28,2755,3.1785714285714284,10,5.7
2025-08-18T11:31:42.180525,41,2796,3.926829268292683,10,4.8
2025-08-18T11:31:42.680729,45,2841,4.0,10,4.9
2025-08-18T11:31:43.180952,44,2885,4.068181818181818,10,5.1
2025-08-18T11:31:43.681194,14,2899,2.9285714285714284,10,4.8
2025-08-18T11:31:44.183606,26,2925,3.6842105263157894,10,4.7
2025-08-18T11:31:44.683870,16,2941,2.8260869565217392,10,4.4
2025-08-18T11:31:45.184141,11,2952,5.090909090909091,10,3.9
2025-08-18T11:31:45.684498,30,2982,3.566666666666667,10,5.8
2025-08-18T11:31:46.184910,9,2991,5.0,10,3.8
2025-08-18T11:31:46.685275,10,3001,2.0,10,4.4
2025-08-18T11:31:47.185716,15,3016,4.666666666666667,10,4.6
2025-08-18T11:31:47.685972,17,3033,4.882352941176471,10,4.4
2025-08-18T11:31:48.186219,15,3048,1.4666666666666666,10,4.6
2025-08-18T11:31:48.686444,29,3077,5.344827586206897,10,5.0
2025-08-18T11:31:49.186635,21,3098,4.523809523809524,10,4.5
2025-08-18T11:31:49.686929,3,3101,2.0,10,4.4
2025-08-18T11:31:50.187261,10,3111,5.5,10,4.6
2025-08-18T11:31:50.687491,10,3121,4.6,10,3.9
2025-08-18T11:31:51.187789,10,3131,5.5,10,4.3
2025-08-18T11:31:51.688096,9,3140,5.0,10,4.2
2025-08-18T11:31:52.188327,10,3150,3.4,10,3.8
2025-08-18T11:31:52.688594,24,3174,4.625,10,4.8
2025-08-18T11:31:53.188821,0,3174,10.0,10,3.4
2025-08-18T11:31:53.689050,17,3191,3.5294117647058822,10,4.8
2025-08-18T11:31:54.189263,17,3208,3.5294117647058822,10,4.5
2025-08-18T11:31:54.689523,10,3218,5.5,10,3.7
2025-08-18T11:31:55.189772,2,3220,1.5,10,3.8
2025-08-18T11:31:55.690016,10,3230,5.5,10,5.8
2025-08-18T11:31:56.190302,10,3240,2.0,10,3.4
2025-08-18T11:31:56.690535,0,3240,5.0,10,3.4
2025-08-18T11:31:57.190763,0,3240,5.0,10,3.6
2025-08-18T11:31:57.691038,20,3260,3.55,10,6.8
2025-08-18T11:31:58.191321,8,3268,1.625,10,4.2
2025-08-18T11:31:58.691797,29,3297,4.0,10,5.2
2025-08-18T11:31:59.192008,32,3329,4.3125,10,5.9
2025-08-18T11:31:59.692265,48,3377,2.9375,10,5.3
2025-08-18T11:32:00.192449,58,3435,4.5344827586206895,10,6.3
2025-08-18T11:32:00.692651,47,3482,4.0212765957446805,10,4.8
2025-08-18T11:32:01.192966,58,3540,3.5344827586206895,10,6.2
2025-08-18T11:32:01.693234,54,3594,4.0,10,5.6
2025-08-18T11:32:02.193549,41,3635,3.926829268292683,10,4.9
2025-08-18T11:32:02.693760,53,3688,4.150943396226415,10,5.9
2025-08-18T11:32:03.194025,17,3705,4.529411764705882,10,4.7
2025-08-18T11:32:03.694252,35,3740,4.6,10,4.7
2025-08-18T11:32:04.194451,37,3777,4.72972972972973,10,4.7
2025-08-18T11:32:04.694639,33,3810,3.6363636363636362,10,5.8
2025-08-18T11:32:05.194856,10,3820,4.6,10,3.5
2025-08-18T11:32:05.695074,0,3820,9.0,10,3.5
2025-08-18T11:32:06.195337,19,3839,3.1578947368421053,10,4.7
2025-08-18T11:32:06.695647,0,3839,9.0,10,3.3
2025-08-18T11:32:07.195886,0,3839,9.0,10,3.6
2025-08-18T11:32:07.696090,20,3859,2.0,10,4.8
2025-08-18T11:32:08.196316,0,3859,3.0,10,3.4
2025-08-18T11:32:08.696531,0,3859,3.0,10,3.7
2025-08-18T11:32:09.196759,0,3859,3.0,10,3.6
2025-08-18T11:32:09.696971,0,3859,3.0,10,3.4
2025-08-18T11:32:10.197261,9,3868,4.111111111111111,10,4.5
2025-08-18T11:32:10.697616,10,3878,4.6,10,5.8
2025-08-18T11:32:11.197861,0,3878,1.0,10,3.6
2025-08-18T11:32:11.698087,0,3878,1.0,10,3.6
2025-08-18T11:32:12.198299,0,3878,1.0,10,3.4
2025-08-18T11:32:12.698523,0,3878,1.0,10,3.4
2025-08-18T11:32:13.198766,0,3878,1.0,10,3.4
2025-08-18T11:32:13.698988,0,3878,1.0,10,3.4
2025-08-18T11:32:14.199225,0,3878,1.0,10,3.3
2025-08-18T11:32:14.699443,0,3878,1.0,10,3.6
2025-08-18T11:32:15.199727,2,3880,1.0,10,4.9
2025-08-18T11:32:15.699943,0,3880,1.0,10,3.4
2025-08-18T11:32:16.200173,0,3880,1.0,10,3.6
2025-08-18T11:32:16.700412,0,3880,1.0,10,3.3
2025-08-18T11:32:17.200678,0,3880,1.0,10,3.3
2025-08-18T11:32:17.700931,10,3890,2.8,10,3.8
2025-08-18T11:32:18.201192,0,3890,6.0,10,3.3
2025-08-18T11:32:18.701448,0,3890,6.0,10,3.7
2025-08-18T11:32:19.201678,0,3890,6.0,10,3.4
2025-08-18T11:32:19.701917,0,3890,6.0,10,3.6
2025-08-18T11:32:20.202197,0,3890,6.0,10,3.6
2025-08-18T11:32:20.702425,0,3890,6.0,10,3.4
2025-08-18T11:32:21.202657,0,3890,6.0,10,3.4
2025-08-18T11:32:21.702911,0,3890,6.0,10,3.4
2025-08-18T11:32:22.203173,0,3890,6.0,10,3.3
2025-08-18T11:32:22.703404,0,3890,6.0,10,3.6
2025-08-18T11:32:23.203643,0,3890,6.0,10,3.3
2025-08-18T11:32:23.703922,0,3890,6.0,10,3.4
2025-08-18T11:32:24.204342,10,3900,3.0,10,4.6
2025-08-18T11:32:24.704730,0,3900,5.0,10,5.9
2025-08-18T11:32:25.205101,10,3910,4.6,10,3.7
2025-08-18T11:32:25.705488,0,3910,1.0,10,3.6
2025-08-18T11:32:26.205906,0,3910,1.0,10,3.7
2025-08-18T11:32:26.706132,0,3910,1.0,10,3.4
2025-08-18T11:32:27.206436,0,3910,1.0,10,3.4
2025-08-18T11:32:27.706718,0,3910,1.0,10,3.4
2025-08-18T11:32:28.206951,0,3910,1.0,10,3.4
2025-08-18T11:32:28.707239,0,3910,1.0,10,3.4
2025-08-18T11:32:29.207479,0,3910,1.0,10,3.5
2025-08-18T11:32:29.707716,0,3910,1.0,10,3.7
2025-08-18T11:32:30.208001,0,3910,1.0,10,3.4
2025-08-18T11:32:30.708235,0,3910,1.0,10,3.5
2025-08-18T11:32:31.208513,0,3910,1.0,10,3.4
2025-08-18T11:32:31.708841,0,3910,1.0,10,4.7
2025-08-18T11:32:32.209225,9,3919,5.0,10,7.1
2025-08-18T11:32:32.709624,0,3919,9.0,10,3.4
2025-08-18T11:32:33.210006,0,3919,9.0,10,3.4
2025-08-18T11:32:33.710393,0,3919,9.0,10,3.3
2025-08-18T11:32:34.210772,10,3929,5.5,10,3.8
2025-08-18T11:32:34.711062,0,3929,10.0,10,3.7
2025-08-18T11:32:35.211420,0,3929,10.0,10,3.4
2025-08-18T11:32:35.711787,0,3929,10.0,10,3.6
2025-08-18T11:32:36.212163,0,3929,10.0,10,3.4
2025-08-18T11:32:36.712565,0,3929,10.0,10,3.5
2025-08-18T11:32:37.212930,0,3929,10.0,10,3.4
2025-08-18T11:32:37.713296,0,3929,10.0,10,3.6
2025-08-18T11:32:38.213719,0,3929,10.0,10,3.5
2025-08-18T11:32:38.714024,0,3929,10.0,10,3.4
2025-08-18T11:32:39.214324,0,3929,10.0,10,3.7
2025-08-18T11:32:39.714612,0,3929,10.0,10,3.6
2025-08-18T11:32:40.214882,0,3929,10.0,10,3.4
2025-08-18T11:32:40.715164,0,3929,10.0,10,3.6
2025-08-18T11:32:41.215460,0,3929,10.0,10,3.4
2025-08-18T11:32:41.715759,0,3929,10.0,10,3.4
2025-08-18T11:32:42.216052,0,3929,10.0,10,3.6
2025-08-18T11:32:42.716320,4,3933,1.25,10,4.5
2025-08-18T11:32:43.216588,0,3933,1.0,10,3.6
2025-08-18T11:32:43.716873,0,3933,1.0,10,3.5
2025-08-18T11:32:44.217146,0,3933,1.0,10,3.6
2025-08-18T11:32:44.717444,10,3943,2.1,10,5.2
2025-08-18T11:32:45.217646,0,3943,1.0,10,3.4
2025-08-18T11:32:45.717915,0,3943,1.0,10,3.7
2025-08-18T11:32:46.218186,0,3943,1.0,10,3.4
2025-08-18T11:32:46.718486,0,3943,1.0,10,3.4
2025-08-18T11:32:47.218704,2,3945,1.0,10,4.8
2025-08-18T11:32:47.718996,10,3955,5.5,10,4.4
2025-08-18T11:32:48.219258,0,3955,10.0,10,3.4
2025-08-18T11:32:48.719478,0,3955,10.0,10,3.5
2025-08-18T11:32:49.219748,0,3955,10.0,10,3.4
2025-08-18T11:32:49.720015,0,3955,10.0,10,3.5
2025-08-18T11:32:50.220280,9,3964,2.7777777777777777,10,4.5
2025-08-18T11:32:50.720500,0,3964,4.0,10,3.7
2025-08-18T11:32:51.220772,10,3974,2.8,10,3.4
2025-08-18T11:32:51.720988,0,3974,3.0,10,3.6
2025-08-18T11:32:52.221254,0,3974,3.0,10,3.4
2025-08-18T11:32:52.721547,0,3974,3.0,10,3.4
2025-08-18T11:32:53.221803,0,3974,3.0,10,3.4
2025-08-18T11:32:53.722018,0,3974,3.0,10,3.3
2025-08-18T11:32:54.222231,20,3994,5.05,10,6.5
2025-08-18T11:32:54.722451,0,3994,9.0,10,3.5
2025-08-18T11:32:55.222642,0,3994,9.0,10,3.6
2025-08-18T11:32:55.722878,0,3994,9.0,10,3.6
2025-08-18T11:32:56.223160,0,3994,9.0,10,3.4
2025-08-18T11:32:56.723436,0,3994,9.0,10,3.4
2025-08-18T11:32:57.223720,1,3995,1.0,10,5.6
2025-08-18T11:32:57.723947,10,4005,1.3,10,4.1
2025-08-18T11:32:58.224215,0,4005,1.0,10,4.1
2025-08-18T11:32:58.724482,0,4005,1.0,10,3.6
2025-08-18T11:32:59.224758,0,4005,1.0,10,3.5
2025-08-18T11:32:59.724982,2,4007,1.5,10,4.8
2025-08-18T11:33:00.225201,10,4017,3.0,10,3.9
2025-08-18T11:33:00.725424,0,4017,5.0,10,3.6
2025-08-18T11:33:01.225653,0,4017,5.0,10,3.4
2025-08-18T11:33:01.725867,0,4017,5.0,10,3.5
2025-08-18T11:33:02.226136,0,4017,5.0,10,3.3
2025-08-18T11:33:02.726361,0,4017,5.0,10,3.3
2025-08-18T11:33:03.226620,3,4020,1.3333333333333333,10,4.6
2025-08-18T11:33:03.726839,10,4030,1.7,10,4.4
2025-08-18T11:33:04.227053,0,4030,2.0,10,3.3
2025-08-18T11:33:04.727322,0,4030,2.0,10,3.8
2025-08-18T11:33:05.227604,0,4030,2.0,10,3.6
2025-08-18T11:33:05.727885,0,4030,2.0,10,3.6
2025-08-18T11:33:06.228113,8,4038,4.5,10,6.0
2025-08-18T11:33:06.728344,0,4038,8.0,10,5.8
2025-08-18T11:33:07.228649,10,4048,2.8,10,3.9
2025-08-18T11:33:07.728899,0,4048,6.0,10,3.4
2025-08-18T11:33:08.229121,0,4048,6.0,10,3.7
2025-08-18T11:33:08.729427,0,4048,6.0,10,3.4
2025-08-18T11:33:09.229638,0,4048,6.0,10,3.4
2025-08-18T11:33:09.729939,0,4048,6.0,10,3.6
2025-08-18T11:33:10.230160,8,4056,4.5,10,6.2
2025-08-18T11:33:10.730411,0,4056,8.0,10,3.8
2025-08-18T11:33:11.230689,0,4056,8.0,10,3.5
2025-08-18T11:33:11.730926,10,4066,5.5,10,3.9
2025-08-18T11:33:12.231148,0,4066,10.0,10,3.4
2025-08-18T11:33:12.731377,0,4066,10.0,10,3.6
2025-08-18T11:33:13.231643,1,4067,1.0,10,6.3
2025-08-18T11:33:13.732050,0,4067,1.0,10,4.2
2025-08-18T11:33:14.232453,10,4077,5.5,10,3.6
2025-08-18T11:33:14.732661,0,4077,10.0,10,3.8
2025-08-18T11:33:15.232895,0,4077,10.0,10,3.4
2025-08-18T11:33:15.733119,0,4077,10.0,10,3.6
2025-08-18T11:33:16.233384,0,4077,10.0,10,3.3
2025-08-18T11:33:16.733640,1,4078,1.0,10,6.0
2025-08-18T11:33:17.233928,0,4078,1.0,10,3.5
2025-08-18T11:33:17.734153,0,4078,1.0,10,3.5
2025-08-18T11:33:18.234388,10,4088,1.3,10,4.0
2025-08-18T11:33:18.734643,0,4088,1.0,10,3.3
2025-08-18T11:33:19.234953,0,4088,1.0,10,3.5
2025-08-18T11:33:19.735224,0,4088,1.0,10,3.6
2025-08-18T11:33:20.235532,0,4088,1.0,10,3.4
2025-08-18T11:33:20.735807,0,4088,1.0,10,3.8
2025-08-18T11:33:21.236103,0,4088,1.0,10,3.4
2025-08-18T11:33:21.736337,0,4088,1.0,10,3.4
2025-08-18T11:33:22.236627,1,4089,1.0,10,4.5
2025-08-18T11:33:22.736859,10,4099,2.7,10,4.1
2025-08-18T11:33:23.237079,0,4099,6.0,10,3.4
2025-08-18T11:33:23.737379,0,4099,6.0,10,3.7
2025-08-18T11:33:24.237672,4,4103,1.25,10,6.0
2025-08-18T11:33:24.737881,10,4113,2.8,10,3.8
2025-08-18T11:33:25.238094,0,4113,6.0,10,3.5
2025-08-18T11:33:25.738352,8,4121,1.125,10,6.1
2025-08-18T11:33:26.238646,10,4131,1.8,10,4.3
2025-08-18T11:33:26.738881,12,4143,2.6666666666666665,10,4.5
2025-08-18T11:33:27.239121,0,4143,5.0,10,3.4
2025-08-18T11:33:27.739396,0,4143,5.0,10,3.4
2025-08-18T11:33:28.239665,5,4148,1.2,10,5.6
2025-08-18T11:33:28.739925,10,4158,5.5,10,3.6
2025-08-18T11:33:29.240206,0,4158,10.0,10,3.4
2025-08-18T11:33:29.740537,0,4158,10.0,10,3.8
2025-08-18T11:33:30.240767,5,4163,1.8,10,4.4
2025-08-18T11:33:30.740998,0,4163,2.0,10,3.6
2025-08-18T11:33:31.241233,10,4173,4.6,10,3.8
2025-08-18T11:33:31.741463,0,4173,9.0,10,3.5
2025-08-18T11:33:32.241743,0,4173,9.0,10,3.5
2025-08-18T11:33:32.742002,0,4173,9.0,10,3.3
2025-08-18T11:33:33.242260,0,4173,9.0,10,3.6
2025-08-18T11:33:33.742488,10,4183,1.6,10,5.1
2025-08-18T11:33:34.242711,0,4183,1.0,10,4.2
2025-08-18T11:33:34.742992,10,4193,1.6,10,4.1
2025-08-18T11:33:35.243223,0,4193,1.0,10,3.6
2025-08-18T11:33:35.743460,0,4193,1.0,10,3.9
2025-08-18T11:33:36.243650,0,4193,1.0,10,3.3
2025-08-18T11:33:36.743874,3,4196,1.3333333333333333,10,5.6
2025-08-18T11:33:37.244098,10,4206,4.6,10,4.5
2025-08-18T11:33:37.744307,10,4216,4.6,10,4.0
2025-08-18T11:33:38.244513,10,4226,1.9,10,5.7
2025-08-18T11:33:38.744833,8,4234,1.75,10,4.2
2025-08-18T11:33:39.245060,10,4244,1.8,10,3.5
2025-08-18T11:33:39.745291,0,4244,1.0,10,3.6
2025-08-18T11:33:40.245518,9,4253,4.111111111111111,10,4.7
2025-08-18T11:33:40.745733,10,4263,2.8,10,3.8
2025-08-18T11:33:41.245988,0,4263,6.0,10,3.4
2025-08-18T11:33:41.746224,10,4273,2.0,10,6.1
2025-08-18T11:33:42.246453,10,4283,3.8,10,4.6
2025-08-18T11:33:42.746687,0,4283,8.0,10,3.5
2025-08-18T11:33:43.246983,5,4288,1.6,10,4.7
2025-08-18T11:33:43.747217,10,4298,2.5,10,3.6
2025-08-18T11:33:44.247460,0,4298,1.0,10,3.5
2025-08-18T11:33:44.747753,2,4300,1.0,10,4.8
2025-08-18T11:33:45.248029,10,4310,2.0,10,3.6
2025-08-18T11:33:45.748257,0,4310,1.0,10,3.8
2025-08-18T11:33:46.248525,8,4318,1.5,10,4.4
2025-08-18T11:33:46.748805,10,4328,5.5,10,4.0
2025-08-18T11:33:47.249079,0,4328,10.0,10,3.4
2025-08-18T11:33:47.749328,5,4333,1.2,10,4.8
2025-08-18T11:33:48.249552,0,4333,1.0,10,3.4
2025-08-18T11:33:48.749825,10,4343,1.7,10,3.4
2025-08-18T11:33:49.250049,0,4343,4.0,10,3.7
2025-08-18T11:33:49.750263,5,4348,1.6,10,3.9
2025-08-18T11:33:50.250535,10,4358,5.5,10,5.6
2025-08-18T11:33:50.750812,0,4358,10.0,10,3.8
2025-08-18T11:33:51.251072,5,4363,3.0,10,5.4
2025-08-18T11:33:51.751309,10,4373,5.5,10,4.3
2025-08-18T11:33:52.251560,5,4378,3.0,10,3.7
2025-08-18T11:33:52.751820,30,4408,2.8,10,5.8
2025-08-18T11:33:53.252112,0,4408,7.0,10,3.4
2025-08-18T11:33:53.752353,1,4409,1.0,10,3.7
2025-08-18T11:33:54.252647,20,4429,2.25,10,6.0
2025-08-18T11:33:54.752887,20,4449,3.75,10,4.8
2025-08-18T11:33:55.253088,13,4462,3.8461538461538463,10,4.4
2025-08-18T11:33:55.753328,0,4462,9.0,10,3.4
2025-08-18T11:33:56.253679,10,4472,1.0,10,3.4
2025-08-18T11:33:56.753992,0,4472,1.0,10,3.6
2025-08-18T11:33:57.254200,1,4473,1.0,10,3.8
2025-08-18T11:33:57.755081,12,4485,1.5,10,4.5
2025-08-18T11:33:58.255342,10,4495,4.6,10,4.9
2025-08-18T11:33:58.755584,0,4495,1.0,10,3.4
2025-08-18T11:33:59.255800,4,4499,1.25,10,4.5
2025-08-18T11:33:59.756152,15,4514,4.066666666666666,10,4.6
2025-08-18T11:34:00.256442,10,4524,1.1,10,3.9
2025-08-18T11:34:00.756679,6,4530,1.3333333333333333,10,4.8
2025-08-18T11:34:01.256984,10,4540,3.1,10,3.4
2025-08-18T11:34:01.757215,11,4551,4.2727272727272725,10,4.8
2025-08-18T11:34:02.257495,10,4561,1.7,10,4.4
2025-08-18T11:34:02.757798,0,4561,1.0,10,3.4
2025-08-18T11:34:03.258096,18,4579,3.111111111111111,10,5.9
2025-08-18T11:34:03.758424,3,4582,2.0,10,4.4
2025-08-18T11:34:04.258743,10,4592,3.1,10,4.7
2025-08-18T11:34:04.758996,18,4610,4.666666666666667,10,4.8
2025-08-18T11:34:05.259237,14,4624,2.5714285714285716,10,4.3
2025-08-18T11:34:05.759550,10,4634,3.8,10,4.0
2025-08-18T11:34:06.259762,1,4635,1.0,10,4.0
2025-08-18T11:34:06.760020,20,4655,4.6,10,4.3
2025-08-18T11:34:07.260295,0,4655,9.0,10,3.5
2025-08-18T11:34:07.760568,15,4670,2.2,10,6.1
2025-08-18T11:34:08.260756,10,4680,5.5,10,3.5
2025-08-18T11:34:08.760979,2,4682,1.5,10,4.4
2025-08-18T11:34:09.261207,10,4692,5.5,10,3.6
2025-08-18T11:34:09.761442,29,4721,2.310344827586207,10,4.9
2025-08-18T11:34:10.261655,6,4727,3.5,10,4.5
2025-08-18T11:34:10.761882,0,4727,6.0,10,3.6
2025-08-18T11:34:11.262122,10,4737,5.5,10,3.5
2025-08-18T11:34:11.762411,0,4737,10.0,10,3.6
2025-08-18T11:34:12.262685,8,4745,1.5,10,4.9
2025-08-18T11:34:12.762912,10,4755,5.5,10,3.5
2025-08-18T11:34:13.263140,0,4755,10.0,10,3.5
2025-08-18T11:34:13.763391,8,4763,3.625,10,4.3
2025-08-18T11:34:14.263668,10,4773,1.7,10,4.8
2025-08-18T11:34:14.763893,2,4775,1.0,10,4.9
2025-08-18T11:34:15.264176,10,4785,2.3,10,3.6
2025-08-18T11:34:15.764386,17,4802,3.2941176470588234,10,4.5
2025-08-18T11:34:16.264647,0,4802,1.0,10,3.3
2025-08-18T11:34:16.764876,0,4802,1.0,10,3.6
2025-08-18T11:34:17.265094,8,4810,4.5,10,4.3
2025-08-18T11:34:17.765321,10,4820,3.2,10,4.3
2025-08-18T11:34:18.265594,0,4820,1.0,10,3.4
2025-08-18T11:34:18.765862,16,4836,3.3125,10,4.7
2025-08-18T11:34:19.266089,10,4846,5.5,10,3.8
2025-08-18T11:34:19.766302,3,4849,2.0,10,6.1
2025-08-18T11:34:20.266576,10,4859,3.9,10,3.6
2025-08-18T11:34:20.766845,12,4871,1.0833333333333333,10,4.8
2025-08-18T11:34:21.267068,3,4874,2.0,10,3.5
2025-08-18T11:34:21.767387,20,4894,2.6,10,6.2
2025-08-18T11:34:22.267683,0,4894,2.0,10,3.4
2025-08-18T11:34:22.767965,9,4903,2.6666666666666665,10,4.4
2025-08-18T11:34:23.268261,10,4913,5.5,10,3.6
2025-08-18T11:34:23.768536,0,4913,10.0,10,3.4
2025-08-18T11:34:24.268761,0,4913,10.0,10,3.5
2025-08-18T11:34:24.768986,14,4927,2.0,10,6.3
2025-08-18T11:34:25.269192,10,4937,2.1,10,3.6
2025-08-18T11:34:25.769472,13,4950,4.538461538461538,10,5.6
2025-08-18T11:34:26.269749,25,4975,4.08,10,5.9
2025-08-18T11:34:26.770022,10,4985,4.6,10,3.5
2025-08-18T11:34:27.270279,0,4985,9.0,10,3.5
2025-08-18T11:34:27.770565,0,4985,9.0,10,3.6
2025-08-18T11:34:28.270839,0,4985,9.0,10,3.3
2025-08-18T11:34:28.771048,0,4985,9.0,10,3.2
2025-08-18T11:34:29.271345,0,4985,9.0,10,3.1
2025-08-18T11:34:29.771669,0,4985,9.0,10,3.4
2025-08-18T11:34:30.271946,10,4995,1.6,10,4.8
2025-08-18T11:34:30.772259,0,4995,1.0,10,3.6
2025-08-18T11:34:31.272545,0,4995,1.0,10,3.4
2025-08-18T11:34:31.772820,0,4995,1.0,10,3.2
2025-08-18T11:34:32.273077,10,5005,1.3,10,4.1
2025-08-18T11:34:32.773305,0,5005,1.0,10,3.3
2025-08-18T11:34:33.273579,0,5005,1.0,10,3.5
2025-08-18T11:34:33.773875,0,5005,1.0,10,3.4
2025-08-18T11:34:34.274174,0,5005,1.0,10,3.2
2025-08-18T11:34:34.774438,0,5005,1.0,10,3.6
2025-08-18T11:34:35.274640,0,5005,1.0,10,3.7
2025-08-18T11:34:35.774914,2,5007,1.0,10,4.5
2025-08-18T11:34:36.275132,10,5017,1.6,10,4.6
2025-08-18T11:34:36.775430,0,5017,1.0,10,3.5
2025-08-18T11:34:37.275640,0,5017,1.0,10,3.5
2025-08-18T11:34:37.775910,0,5017,1.0,10,3.5
2025-08-18T11:34:38.276195,0,5017,1.0,10,3.4
2025-08-18T11:34:38.776415,0,5017,1.0,10,3.6
2025-08-18T11:34:39.276671,0,5017,1.0,10,3.5
2025-08-18T11:34:39.776953,0,5017,1.0,10,3.8
2025-08-18T11:34:40.277163,0,5017,1.0,10,3.3
2025-08-18T11:34:40.777459,0,5017,1.0,10,3.2
2025-08-18T11:34:41.277745,0,5017,1.0,10,3.2
2025-08-18T11:34:41.813884,16,5033,2.0,10,7.7
2025-08-18T11:34:42.314135,0,5033,1.6666666666666667,10,5.0
2025-08-18T11:34:42.814361,0,5033,3.0,10,3.5
2025-08-18T11:34:43.314589,0,5033,3.0,10,3.6
2025-08-18T11:34:43.814811,10,5043,1.6,10,3.9
2025-08-18T11:34:44.315027,0,5043,1.0,10,3.3
2025-08-18T11:34:44.815249,0,5043,1.0,10,3.6
2025-08-18T11:34:45.315463,0,5043,1.0,10,3.5
2025-08-18T11:34:45.815747,1,5044,1.0,10,4.6
2025-08-18T11:34:46.316014,0,5044,1.0,10,3.5
2025-08-18T11:34:46.816256,0,5044,1.0,10,3.5
2025-08-18T11:34:47.316525,0,5044,1.0,10,3.4
2025-08-18T11:34:47.816765,0,5044,1.0,10,3.3
2025-08-18T11:34:48.317070,0,5044,1.0,10,3.2
2025-08-18T11:34:48.817329,0,5044,1.0,10,3.2
2025-08-18T11:34:49.317604,0,5044,1.0,10,3.2
2025-08-18T11:34:49.817836,10,5054,1.8,10,4.4
2025-08-18T11:34:50.318060,0,5054,4.0,10,3.4
2025-08-18T11:34:50.818293,0,5054,4.0,10,3.7
2025-08-18T11:34:51.318520,0,5054,4.0,10,3.5
2025-08-18T11:34:51.818812,5,5059,1.4,10,4.5
2025-08-18T11:34:52.319084,10,5069,5.5,10,3.7
2025-08-18T11:34:52.819412,0,5069,10.0,10,3.5
2025-08-18T11:34:53.319719,0,5069,10.0,10,3.4
2025-08-18T11:34:53.820001,0,5069,10.0,10,3.2
2025-08-18T11:34:54.320295,0,5069,10.0,10,3.2
2025-08-18T11:34:54.820595,0,5069,10.0,10,3.6
2025-08-18T11:34:55.320894,0,5069,10.0,10,3.5
2025-08-18T11:34:55.821126,0,5069,10.0,10,3.4
2025-08-18T11:34:56.321396,0,5069,10.0,10,3.3
2025-08-18T11:34:56.821615,10,5079,3.9,10,4.2
2025-08-18T11:34:57.321897,0,5079,8.0,10,6.7
2025-08-18T11:34:57.822130,0,5079,8.0,10,4.9
2025-08-18T11:34:58.322543,0,5079,8.0,10,4.0
2025-08-18T11:34:58.822770,0,5079,8.0,10,3.3
2025-08-18T11:34:59.323070,10,5089,2.8,10,4.3
2025-08-18T11:34:59.823322,0,5089,3.0,10,3.6
2025-08-18T11:35:00.323685,0,5089,3.0,10,3.8
2025-08-18T11:35:00.823989,0,5089,3.0,10,3.6
2025-08-18T11:35:01.324246,0,5089,3.0,10,3.2
2025-08-18T11:35:01.824896,0,5089,3.0,10,1.6
2025-08-18T11:35:02.325876,0,5089,3.0,10,0.2
2025-08-18T11:35:02.826749,0,5089,3.0,10,0.2
2025-08-18T11:35:03.327563,0,5089,3.0,10,0.5
2025-08-18T11:35:03.828422,0,5089,3.0,10,0.3
2025-08-18T11:35:04.329229,0,5089,3.0,10,0.2
2025-08-18T11:35:04.830233,0,5089,3.0,10,0.6
2025-08-18T11:35:05.331066,0,5089,3.0,10,0.2
2025-08-18T11:35:05.831911,0,5089,3.0,10,0.2
2025-08-18T11:35:06.332761,0,5089,3.0,10,0.1
2025-08-18T11:35:06.833641,0,5089,3.0,10,0.1
2025-08-18T11:35:07.334332,0,5089,3.0,10,0.2
2025-08-18T11:35:07.835139,0,5089,3.0,10,0.1
2025-08-18T11:35:08.335977,0,5089,3.0,10,0.1
2025-08-18T11:35:08.836690,0,5089,3.0,10,0.8
2025-08-18T11:35:09.337313,0,5089,3.0,10,0.9
2025-08-18T11:35:09.837900,0,5089,3.0,10,1.8
2025-08-18T11:35:10.338673,0,5089,3.0,10,0.4
2025-08-18T11:35:10.839601,0,5089,3.0,10,0.4
2025-08-18T11:35:11.340335,0,5089,3.0,10,0.1
2025-08-18T11:35:11.841186,0,5089,3.0,10,0.1
2025-08-18T11:35:12.341814,0,5089,3.0,10,0.1
2025-08-18T11:35:12.842484,0,5089,3.0,10,0.1
2025-08-18T11:35:13.343177,0,5089,3.0,10,0.1
2025-08-18T11:35:13.843884,0,5089,3.0,10,0.2
2025-08-18T11:35:14.344555,0,5089,3.0,10,0.2
2025-08-18T11:35:14.845216,0,5089,3.0,10,0.2
2025-08-18T11:35:15.345985,0,5089,3.0,10,0.2
2025-08-18T11:35:15.846767,0,5089,3.0,10,0.1
2025-08-18T11:35:16.347410,0,5089,3.0,10,0.1
2025-08-18T11:35:16.848222,0,5089,3.0,10,0.1
2025-08-18T11:35:17.348940,0,5089,3.0,10,0.2
2025-08-18T11:35:17.849691,0,5089,3.0,10,0.1
2025-08-18T11:35:18.350406,0,5089,3.0,10,0.1
2025-08-18T11:35:18.851181,0,5089,3.0,10,0.2
2025-08-18T11:35:19.351956,0,5089,3.0,10,0.4
2025-08-18T11:35:19.852793,0,5089,3.0,10,0.1
2025-08-18T11:35:20.353614,0,5089,3.0,10,0.1
2025-08-18T11:35:20.854344,0,5089,3.0,10,0.1
2025-08-18T11:35:21.354998,0,5089,3.0,10,0.2
2025-08-18T11:35:21.855824,0,5089,3.0,10,0.1
2025-08-18T11:35:22.356502,0,5089,3.0,10,0.2
2025-08-18T11:35:22.857287,0,5089,3.0,10,0.1
2025-08-18T11:35:23.358032,0,5089,3.0,10,0.1
2025-08-18T11:35:23.858775,0,5089,3.0,10,0.2
2025-08-18T11:35:24.359390,0,5089,3.0,10,0.2
2025-08-18T11:35:24.860109,0,5089,3.0,10,0.1
2025-08-18T11:35:25.360914,0,5089,3.0,10,0.1
2025-08-18T11:35:25.861639,0,5089,3.0,10,0.2
2025-08-18T11:35:26.362365,0,5089,3.0,10,0.2
2025-08-18T11:35:26.863148,0,5089,3.0,10,0.1
2025-08-18T11:35:27.363945,0,5089,3.0,10,0.2
2025-08-18T11:35:27.864732,0,5089,3.0,10,0.2
2025-08-18T11:35:28.365420,0,5089,3.0,10,0.1
2025-08-18T11:35:28.866209,0,5089,3.0,10,0.2
2025-08-18T11:35:29.366985,0,5089,3.0,10,0.2
2025-08-18T11:35:29.867774,0,5089,3.0,10,0.1
2025-08-18T11:35:30.368573,0,5089,3.0,10,0.1
2025-08-18T11:35:30.869386,0,5089,3.0,10,0.1
2025-08-18T11:35:31.370163,0,5089,3.0,10,0.1
2025-08-18T11:35:31.870934,0,5089,3.0,10,0.2
2025-08-18T11:35:32.371702,0,5089,3.0,10,0.2
2025-08-18T11:35:32.872450,0,5089,3.0,10,0.2
2025-08-18T11:35:33.373271,0,5089,3.0,10,0.1
2025-08-18T11:35:33.873958,0,5089,3.0,10,0.2
2025-08-18T11:35:34.374724,0,5089,3.0,10,0.2
2025-08-18T11:35:34.875456,0,5089,3.0,10,0.1
2025-08-18T11:35:35.376224,0,5089,3.0,10,0.2
2025-08-18T11:35:35.877013,0,5089,3.0,10,0.1
2025-08-18T11:35:36.377879,0,5089,3.0,10,0.2
2025-08-18T11:35:36.878706,0,5089,3.0,10,0.1
2025-08-18T11:35:37.379466,0,5089,3.0,10,0.1
2025-08-18T11:35:37.880320,0,5089,3.0,10,0.2
2025-08-18T11:35:38.381066,0,5089,3.0,10,0.1
2025-08-18T11:35:38.881858,0,5089,3.0,10,0.9
2025-08-18T11:35:39.382461,0,5089,3.0,10,0.9
2025-08-18T11:35:39.883006,0,5089,3.0,10,1.9
2025-08-18T11:35:40.383745,0,5089,3.0,10,0.6
2025-08-18T11:35:40.884383,0,5089,3.0,10,0.4
2025-08-18T11:35:41.385057,0,5089,3.0,10,0.2
2025-08-18T11:35:41.885795,0,5089,3.0,10,0.1
2025-08-18T11:35:42.386565,0,5089,3.0,10,0.2
2025-08-18T11:35:42.887266,0,5089,3.0,10,0.1
2025-08-18T11:35:43.388036,0,5089,3.0,10,0.1
2025-08-18T11:35:43.889091,0,5089,3.0,10,0.2
2025-08-18T11:35:44.390019,0,5089,3.0,10,0.2
2025-08-18T11:35:44.890749,0,5089,3.0,10,0.2
2025-08-18T11:35:45.391428,0,5089,3.0,10,0.1
2025-08-18T11:35:45.892055,0,5089,3.0,10,0.1
2025-08-18T11:35:46.392789,0,5089,3.0,10,0.1
2025-08-18T11:35:46.893386,0,5089,3.0,10,0.2
2025-08-18T11:35:47.394123,0,5089,3.0,10,0.1
2025-08-18T11:35:47.894926,0,5089,3.0,10,0.1
2025-08-18T11:35:48.395680,0,5089,3.0,10,0.9
2025-08-18T11:35:48.896406,0,5089,3.0,10,0.1
2025-08-18T11:35:49.397166,0,5089,3.0,10,2.2
2025-08-18T11:35:49.897955,0,5089,3.0,10,0.4
2025-08-18T11:35:50.398765,0,5089,3.0,10,0.2
2025-08-18T11:35:50.899488,0,5089,3.0,10,0.1
2025-08-18T11:35:51.400278,0,5089,3.0,10,0.2
2025-08-18T11:35:51.901076,0,5089,3.0,10,0.2
2025-08-18T11:35:52.401821,0,5089,3.0,10,0.1
2025-08-18T11:35:52.902568,0,5089,3.0,10,0.6
2025-08-18T11:35:53.403246,0,5089,3.0,10,0.2
2025-08-18T11:35:53.903984,0,5089,3.0,10,0.2
2025-08-18T11:35:54.404694,0,5089,3.0,10,0.1
2025-08-18T11:35:54.905393,0,5089,3.0,10,0.1
2025-08-18T11:35:55.406143,0,5089,3.0,10,0.1
2025-08-18T11:35:55.906859,0,5089,3.0,10,0.1
2025-08-18T11:35:56.407600,0,5089,3.0,10,0.0
2025-08-18T11:35:56.908270,0,5089,3.0,10,0.2
2025-08-18T11:35:57.408940,0,5089,3.0,10,0.1
2025-08-18T11:35:57.909642,0,5089,3.0,10,0.1
2025-08-18T11:35:58.410321,0,5089,3.0,10,1.0
2025-08-18T11:35:58.911068,0,5089,3.0,10,0.1
2025-08-18T11:35:59.411799,0,5089,3.0,10,0.3
2025-08-18T11:35:59.912552,0,5089,3.0,10,0.1
2025-08-18T11:36:00.413321,0,5089,3.0,10,0.1
2025-08-18T11:36:00.914006,0,5089,3.0,10,0.2
2025-08-18T11:36:01.414842,0,5089,3.0,10,0.2
2025-08-18T11:36:01.915650,0,5089,3.0,10,0.1
2025-08-18T11:36:02.416487,0,5089,3.0,10,0.1
2025-08-18T11:36:02.917343,0,5089,3.0,10,0.1
2025-08-18T11:36:03.418184,0,5089,3.0,10,0.6
2025-08-18T11:36:03.919069,0,5089,3.0,10,0.2
2025-08-18T11:36:04.419951,0,5089,3.0,10,0.2
2025-08-18T11:36:04.920879,0,5089,3.0,10,0.1
2025-08-18T11:36:05.421649,0,5089,3.0,10,0.1
2025-08-18T11:36:05.922309,0,5089,3.0,10,0.2
2025-08-18T11:36:06.422981,0,5089,3.0,10,0.1
2025-08-18T11:36:06.923819,0,5089,3.0,10,0.1
2025-08-18T11:36:07.424539,0,5089,3.0,10,0.0
2025-08-18T11:36:07.925359,0,5089,3.0,10,0.2
2025-08-18T11:36:08.426100,0,5089,3.0,10,0.2
2025-08-18T11:36:08.926780,0,5089,3.0,10,0.7
2025-08-18T11:36:09.427431,0,5089,3.0,10,0.6
2025-08-18T11:36:09.927987,0,5089,3.0,10,2.1
2025-08-18T11:36:10.428765,0,5089,3.0,10,0.7
2025-08-18T11:36:10.929413,0,5089,3.0,10,0.3
2025-08-18T11:36:11.430211,0,5089,3.0,10,0.3
2025-08-18T11:36:11.930994,0,5089,3.0,10,0.1
2025-08-18T11:36:12.431798,0,5089,3.0,10,0.2
2025-08-18T11:36:12.932618,0,5089,3.0,10,0.1
2025-08-18T11:36:13.433414,0,5089,3.0,10,0.1
2025-08-18T11:36:13.934268,0,5089,3.0,10,0.2
2025-08-18T11:36:14.435047,0,5089,3.0,10,0.2
2025-08-18T11:36:14.935846,0,5089,3.0,10,0.1
2025-08-18T11:36:15.436662,0,5089,3.0,10,0.1
2025-08-18T11:36:15.937408,0,5089,3.0,10,0.2
2025-08-18T11:36:16.438176,0,5089,3.0,10,0.3
2025-08-18T11:36:16.938970,0,5089,3.0,10,0.1
2025-08-18T11:36:17.439725,0,5089,3.0,10,0.2
2025-08-18T11:36:17.940415,0,5089,3.0,10,0.1
2025-08-18T11:36:18.441167,0,5089,3.0,10,0.1
2025-08-18T11:36:18.941961,0,5089,3.0,10,0.1
2025-08-18T11:36:19.442835,0,5089,3.0,10,0.3
2025-08-18T11:36:19.943691,0,5089,3.0,10,0.1
2025-08-18T11:36:20.444297,0,5089,3.0,10,0.1
2025-08-18T11:36:20.945095,0,5089,3.0,10,0.1
2025-08-18T11:36:21.445932,0,5089,3.0,10,0.1
2025-08-18T11:36:21.946681,0,5089,3.0,10,0.2
2025-08-18T11:36:22.447548,0,5089,3.0,10,0.1
2025-08-18T11:36:22.948323,0,5089,3.0,10,0.1
2025-08-18T11:36:23.449110,0,5089,3.0,10,0.1
2025-08-18T11:36:23.949910,0,5089,3.0,10,0.1
2025-08-18T11:36:24.450692,0,5089,3.0,10,0.2
2025-08-18T11:36:24.951399,0,5089,3.0,10,0.1
2025-08-18T11:36:25.452152,0,5089,3.0,10,0.1
2025-08-18T11:36:25.952926,0,5089,3.0,10,0.1
2025-08-18T11:36:26.453685,0,5089,3.0,10,0.1
2025-08-18T11:36:26.954367,0,5089,3.0,10,0.1
2025-08-18T11:36:27.455105,0,5089,3.0,10,0.1
2025-08-18T11:36:27.955817,0,5089,3.0,10,0.1
2025-08-18T11:36:28.456574,0,5089,3.0,10,0.1
2025-08-18T11:36:28.957357,0,5089,3.0,10,0.1
2025-08-18T11:36:29.458103,0,5089,3.0,10,0.2
2025-08-18T11:36:29.958859,0,5089,3.0,10,0.1
2025-08-18T11:36:30.459657,0,5089,3.0,10,0.1
2025-08-18T11:36:30.960437,0,5089,3.0,10,0.1
2025-08-18T11:36:31.461184,0,5089,3.0,10,0.1
2025-08-18T11:36:31.962003,0,5089,3.0,10,0.2
2025-08-18T11:36:32.462825,0,5089,3.0,10,0.2
2025-08-18T11:36:32.963536,0,5089,3.0,10,0.1
2025-08-18T11:36:33.464319,0,5089,3.0,10,0.1
2025-08-18T11:36:33.965082,0,5089,3.0,10,0.2
2025-08-18T11:36:34.465855,0,5089,3.0,10,0.1
2025-08-18T11:36:34.966624,0,5089,3.0,10,0.1
2025-08-18T11:36:35.467310,0,5089,3.0,10,0.1
2025-08-18T11:36:35.967964,0,5089,3.0,10,0.2
2025-08-18T11:36:36.468780,0,5089,3.0,10,0.1
2025-08-18T11:36:36.969567,0,5089,3.0,10,0.1
2025-08-18T11:36:37.470272,0,5089,3.0,10,0.1
2025-08-18T11:36:37.970956,0,5089,3.0,10,0.1
2025-08-18T11:36:38.471666,0,5089,3.0,10,0.1
2025-08-18T11:36:38.971972,0,5089,3.0,10,0.2
2025-08-18T11:36:39.472655,0,5089,3.0,10,0.7
2025-08-18T11:36:39.973206,0,5089,3.0,10,1.6
2025-08-18T11:36:40.473963,0,5089,3.0,10,1.3
2025-08-18T11:36:40.974588,0,5089,3.0,10,0.2
2025-08-18T11:36:41.475393,0,5089,3.0,10,0.3
2025-08-18T11:36:41.976100,0,5089,3.0,10,0.1
2025-08-18T11:36:42.476842,0,5089,3.0,10,0.2
2025-08-18T11:36:42.977383,0,5089,3.0,10,0.3
2025-08-18T11:36:43.478065,0,5089,3.0,10,0.2
2025-08-18T11:36:43.978809,0,5089,3.0,10,0.1
2025-08-18T11:36:44.479578,0,5089,3.0,10,0.2
2025-08-18T11:36:44.980412,0,5089,3.0,10,0.2
2025-08-18T11:36:45.481180,0,5089,3.0,10,1.8
2025-08-18T11:36:45.981885,0,5089,3.0,10,0.1
2025-08-18T11:36:46.482722,0,5089,3.0,10,0.1
2025-08-18T11:36:46.983425,0,5089,3.0,10,0.1
2025-08-18T11:36:47.484057,0,5089,3.0,10,0.2
2025-08-18T11:36:47.984804,0,5089,3.0,10,0.1
2025-08-18T11:36:48.485506,0,5089,3.0,10,0.3
2025-08-18T11:36:48.986266,0,5089,3.0,10,0.2
2025-08-18T11:36:49.487033,0,5089,3.0,10,0.3
2025-08-18T11:36:49.987784,0,5089,3.0,10,0.1
2025-08-18T11:36:50.488560,0,5089,3.0,10,0.1
2025-08-18T11:36:50.989297,0,5089,3.0,10,0.1
2025-08-18T11:36:51.490007,0,5089,3.0,10,0.2
2025-08-18T11:36:51.990690,0,5089,3.0,10,0.1
2025-08-18T11:36:52.491394,0,5089,3.0,10,0.1
2025-08-18T11:36:52.991957,0,5089,3.0,10,0.2
2025-08-18T11:36:53.492744,0,5089,3.0,10,0.1
2025-08-18T11:36:53.993555,0,5089,3.0,10,0.2
2025-08-18T11:36:54.494303,0,5089,3.0,10,0.2
2025-08-18T11:36:54.995033,0,5089,3.0,10,0.2
2025-08-18T11:36:55.495752,0,5089,3.0,10,0.1
2025-08-18T11:36:55.996503,0,5089,3.0,10,0.1
2025-08-18T11:36:56.497275,0,5089,3.0,10,0.1
2025-08-18T11:36:56.998012,0,5089,3.0,10,0.1
2025-08-18T11:36:57.498811,0,5089,3.0,10,0.1
2025-08-18T11:36:57.999597,0,5089,3.0,10,0.1
2025-08-18T11:36:58.500306,0,5089,3.0,10,0.7
2025-08-18T11:36:59.001071,0,5089,3.0,10,0.2
2025-08-18T11:36:59.501887,0,5089,3.0,10,0.2
2025-08-18T11:37:00.002689,0,5089,3.0,10,0.2
2025-08-18T11:37:00.503474,0,5089,3.0,10,0.2
2025-08-18T11:37:01.004356,0,5089,3.0,10,0.2
2025-08-18T11:37:01.505145,0,5089,3.0,10,0.1
2025-08-18T11:37:02.005999,0,5089,3.0,10,0.1
2025-08-18T11:37:02.506888,0,5089,3.0,10,0.2
2025-08-18T11:37:03.007793,0,5089,3.0,10,0.2
2025-08-18T11:37:03.508755,0,5089,3.0,10,0.3
2025-08-18T11:37:04.009358,0,5089,3.0,10,0.1
2025-08-18T11:37:04.510076,0,5089,3.0,10,0.4
2025-08-18T11:37:05.010959,0,5089,3.0,10,0.2
2025-08-18T11:37:05.511803,0,5089,3.0,10,0.2
2025-08-18T11:37:06.012651,0,5089,3.0,10,0.1
2025-08-18T11:37:06.513443,0,5089,3.0,10,0.2
2025-08-18T11:37:07.014145,0,5089,3.0,10,0.1
2025-08-18T11:37:07.514987,0,5089,3.0,10,0.2
2025-08-18T11:37:08.015874,0,5089,3.0,10,0.3
2025-08-18T11:37:08.516686,0,5089,3.0,10,0.2
2025-08-18T11:37:09.017252,0,5089,3.0,10,0.1
2025-08-18T11:37:09.518036,0,5089,3.0,10,0.8
2025-08-18T11:37:10.018613,0,5089,3.0,10,1.4
2025-08-18T11:37:10.519257,0,5089,3.0,10,1.9
2025-08-18T11:37:11.020000,0,5089,3.0,10,0.3
2025-08-18T11:37:11.520737,0,5089,3.0,10,0.3
2025-08-18T11:37:12.021594,0,5089,3.0,10,0.2
2025-08-18T11:37:12.522341,0,5089,3.0,10,0.2
2025-08-18T11:37:13.023167,0,5089,3.0,10,0.1
2025-08-18T11:37:13.523967,0,5089,3.0,10,0.2
2025-08-18T11:37:14.024726,0,5089,3.0,10,0.1
2025-08-18T11:37:14.525428,0,5089,3.0,10,0.2
2025-08-18T11:37:15.026171,0,5089,3.0,10,0.2
2025-08-18T11:37:15.526955,0,5089,3.0,10,0.2
2025-08-18T11:37:16.027368,0,5089,3.0,10,0.2
2025-08-18T11:37:16.528360,0,5089,3.0,10,0.1
2025-08-18T11:37:17.029351,0,5089,3.0,10,0.1
2025-08-18T11:37:17.530413,0,5089,3.0,10,0.1
2025-08-18T11:37:18.031568,0,5089,3.0,10,0.2
2025-08-18T11:37:18.532598,0,5089,3.0,10,0.1
2025-08-18T11:37:19.033368,0,5089,3.0,10,0.2
2025-08-18T11:37:19.534162,0,5089,3.0,10,0.2
2025-08-18T11:37:20.035022,0,5089,3.0,10,0.1
2025-08-18T11:37:20.535983,0,5089,3.0,10,0.1
2025-08-18T11:37:21.036698,0,5089,3.0,10,0.1
2025-08-18T11:37:21.537386,0,5089,3.0,10,0.1
2025-08-18T11:37:22.038087,0,5089,3.0,10,0.1
2025-08-18T11:37:22.538847,0,5089,3.0,10,0.2
2025-08-18T11:37:23.039639,0,5089,3.0,10,0.2
2025-08-18T11:37:23.540382,0,5089,3.0,10,0.2
2025-08-18T11:37:24.041131,0,5089,3.0,10,0.1
2025-08-18T11:37:24.541931,0,5089,3.0,10,0.2
2025-08-18T11:37:25.042681,0,5089,3.0,10,0.1
2025-08-18T11:37:25.543418,0,5089,3.0,10,0.2
2025-08-18T11:37:26.044194,0,5089,3.0,10,0.1
2025-08-18T11:37:26.544975,0,5089,3.0,10,0.1
2025-08-18T11:37:27.045893,0,5089,3.0,10,0.1
2025-08-18T11:37:27.546627,0,5089,3.0,10,0.2
2025-08-18T11:37:28.047007,0,5089,3.0,10,0.7
2025-08-18T11:37:28.547759,0,5089,3.0,10,1.2
2025-08-18T11:37:29.048487,0,5089,3.0,10,0.1
2025-08-18T11:37:29.549273,0,5089,3.0,10,0.2
2025-08-18T11:37:30.050055,0,5089,3.0,10,0.3
2025-08-18T11:37:30.550939,0,5089,3.0,10,0.1
2025-08-18T11:37:31.051748,0,5089,3.0,10,0.2
2025-08-18T11:37:31.552585,0,5089,3.0,10,0.1
2025-08-18T11:37:32.053392,0,5089,3.0,10,0.2
2025-08-18T11:37:32.554211,0,5089,3.0,10,0.2
2025-08-18T11:37:33.054994,0,5089,3.0,10,0.1
2025-08-18T11:37:33.555793,0,5089,3.0,10,0.2
2025-08-18T11:37:34.056597,0,5089,3.0,10,0.2
2025-08-18T11:37:34.557355,0,5089,3.0,10,0.1
2025-08-18T11:37:35.058116,0,5089,3.0,10,0.1
2025-08-18T11:37:35.558957,0,5089,3.0,10,0.2
2025-08-18T11:37:36.059736,0,5089,3.0,10,0.2
2025-08-18T11:37:36.560608,0,5089,3.0,10,0.1
2025-08-18T11:37:37.061407,0,5089,3.0,10,0.2
2025-08-18T11:37:37.562251,0,5089,3.0,10,0.1
2025-08-18T11:37:38.063099,0,5089,3.0,10,0.1
2025-08-18T11:37:38.563940,0,5089,3.0,10,0.2
2025-08-18T11:37:39.064687,0,5089,3.0,10,0.2
2025-08-18T11:37:39.565325,0,5089,3.0,10,0.9
2025-08-18T11:37:40.065920,0,5089,3.0,10,1.1
2025-08-18T11:37:40.566556,0,5089,3.0,10,2.0
2025-08-18T11:37:41.067261,0,5089,3.0,10,0.1
2025-08-18T11:37:41.567968,0,5089,3.0,10,0.6
2025-08-18T11:37:42.068646,0,5089,3.0,10,0.1
2025-08-18T11:37:42.569249,0,5089,3.0,10,0.2
2025-08-18T11:37:43.070009,0,5089,3.0,10,0.1
2025-08-18T11:37:43.570800,0,5089,3.0,10,0.1
2025-08-18T11:37:44.071495,0,5089,3.0,10,0.1
2025-08-18T11:37:44.572276,0,5089,3.0,10,0.2
2025-08-18T11:37:45.073018,0,5089,3.0,10,0.2
2025-08-18T11:37:45.573824,0,5089,3.0,10,0.1
2025-08-18T11:37:46.074560,0,5089,3.0,10,0.1
2025-08-18T11:37:46.575311,0,5089,3.0,10,0.1
2025-08-18T11:37:47.076073,0,5089,3.0,10,0.1
2025-08-18T11:37:47.576800,0,5089,3.0,10,0.2
2025-08-18T11:37:48.077476,0,5089,3.0,10,0.2
2025-08-18T11:37:48.578198,0,5089,3.0,10,0.2
2025-08-18T11:37:49.078798,0,5089,3.0,10,0.4
2025-08-18T11:37:49.579501,0,5089,3.0,10,0.2
2025-08-18T11:37:50.080323,0,5089,3.0,10,0.1
2025-08-18T11:37:50.581054,0,5089,3.0,10,0.1
2025-08-18T11:37:51.081771,0,5089,3.0,10,0.1
2025-08-18T11:37:51.582597,0,5089,3.0,10,1.9
2025-08-18T11:37:52.083352,0,5089,3.0,10,0.1
2025-08-18T11:37:52.584074,0,5089,3.0,10,0.2
2025-08-18T11:37:53.084785,0,5089,3.0,10,0.2
2025-08-18T11:37:53.585443,0,5089,3.0,10,0.2
2025-08-18T11:37:54.086174,0,5089,3.0,10,0.1
2025-08-18T11:37:54.586976,0,5089,3.0,10,0.1
2025-08-18T11:37:55.087707,0,5089,3.0,10,0.2
2025-08-18T11:37:55.588382,0,5089,3.0,10,0.2
2025-08-18T11:37:56.089152,0,5089,3.0,10,0.1
2025-08-18T11:37:56.589881,0,5089,3.0,10,0.1
2025-08-18T11:37:57.090597,0,5089,3.0,10,0.1
2025-08-18T11:37:57.591309,0,5089,3.0,10,0.2
2025-08-18T11:37:58.092121,0,5089,3.0,10,0.2
2025-08-18T11:37:58.592794,0,5089,3.0,10,0.7
2025-08-18T11:37:59.093487,0,5089,3.0,10,0.2
2025-08-18T11:37:59.594255,0,5089,3.0,10,0.1
2025-08-18T11:38:00.094984,0,5089,3.0,10,0.3
2025-08-18T11:38:00.595692,0,5089,3.0,10,0.1
2025-08-18T11:38:01.096308,0,5089,3.0,10,0.2
2025-08-18T11:38:01.597041,0,5089,3.0,10,0.1
2025-08-18T11:38:02.097738,0,5089,3.0,10,0.2
2025-08-18T11:38:02.598319,0,5089,3.0,10,0.1
2025-08-18T11:38:03.099027,0,5089,3.0,10,0.4
2025-08-18T11:38:03.599752,0,5089,3.0,10,0.2
2025-08-18T11:38:04.100507,0,5089,3.0,10,0.1
2025-08-18T11:38:04.601347,0,5089,3.0,10,0.2
2025-08-18T11:38:05.102087,0,5089,3.0,10,0.2
2025-08-18T11:38:05.602850,0,5089,3.0,10,0.1
2025-08-18T11:38:06.103602,0,5089,3.0,10,0.0
2025-08-18T11:38:06.604326,0,5089,3.0,10,0.1
2025-08-18T11:38:07.105074,0,5089,3.0,10,0.1
2025-08-18T11:38:07.605879,0,5089,3.0,10,0.1
2025-08-18T11:38:08.106704,0,5089,3.0,10,0.2
2025-08-18T11:38:08.607408,0,5089,3.0,10,0.1
2025-08-18T11:38:09.108093,0,5089,3.0,10,0.1
2025-08-18T11:38:09.608762,0,5089,3.0,10,1.0
2025-08-18T11:38:10.109321,0,5089,3.0,10,0.8
2025-08-18T11:38:10.609906,0,5089,3.0,10,1.8
2025-08-18T11:38:11.110658,0,5089,3.0,10,0.4
2025-08-18T11:38:11.611429,0,5089,3.0,10,0.3
2025-08-18T11:38:12.112162,0,5089,3.0,10,0.2
2025-08-18T11:38:12.612947,0,5089,3.0,10,0.2
2025-08-18T11:38:13.113745,0,5089,3.0,10,0.2
2025-08-18T11:38:13.614387,0,5089,3.0,10,0.1
2025-08-18T11:38:14.115061,0,5089,3.0,10,0.1
2025-08-18T11:38:14.615757,0,5089,3.0,10,0.2
2025-08-18T11:38:15.116501,0,5089,3.0,10,0.1
2025-08-18T11:38:15.617189,0,5089,3.0,10,0.1
2025-08-18T11:38:16.117892,0,5089,3.0,10,0.2
2025-08-18T11:38:16.618586,0,5089,3.0,10,0.1
2025-08-18T11:38:17.119255,0,5089,3.0,10,0.1
2025-08-18T11:38:17.619986,0,5089,3.0,10,0.1
2025-08-18T11:38:18.120751,0,5089,3.0,10,0.1
2025-08-18T11:38:18.621480,0,5089,3.0,10,0.2
2025-08-18T11:38:19.122194,0,5089,3.0,10,0.2
2025-08-18T11:38:19.622932,0,5089,3.0,10,0.2
2025-08-18T11:38:20.123680,0,5089,3.0,10,0.1
2025-08-18T11:38:20.624382,0,5089,3.0,10,0.1
2025-08-18T11:38:21.125047,0,5089,3.0,10,0.1
2025-08-18T11:38:21.625766,0,5089,3.0,10,0.1
2025-08-18T11:38:22.126565,0,5089,3.0,10,0.2
2025-08-18T11:38:22.627346,0,5089,3.0,10,0.1
2025-08-18T11:38:23.128121,0,5089,3.0,10,0.1
2025-08-18T11:38:23.628870,0,5089,3.0,10,0.2
2025-08-18T11:38:24.129600,0,5089,3.0,10,0.1
2025-08-18T11:38:24.630409,0,5089,3.0,10,0.2
2025-08-18T11:38:25.131146,0,5089,3.0,10,0.2
2025-08-18T11:38:25.632039,0,5089,3.0,10,0.0
2025-08-18T11:38:26.132820,0,5089,3.0,10,0.1
2025-08-18T11:38:26.633644,0,5089,3.0,10,0.1
2025-08-18T11:38:27.134576,0,5089,3.0,10,0.1
2025-08-18T11:38:27.635405,0,5089,3.0,10,0.2
2025-08-18T11:38:28.136267,0,5089,3.0,10,0.1
2025-08-18T11:38:28.637139,0,5089,3.0,10,0.1
2025-08-18T11:38:29.138004,0,5089,3.0,10,0.2
2025-08-18T11:38:29.638907,0,5089,3.0,10,0.2
2025-08-18T11:38:30.139724,0,5089,3.0,10,0.2
2025-08-18T11:38:30.640494,0,5089,3.0,10,0.2
2025-08-18T11:38:31.141314,0,5089,3.0,10,0.1
2025-08-18T11:38:31.642193,0,5089,3.0,10,0.2
2025-08-18T11:38:32.143044,0,5089,3.0,10,0.1
2025-08-18T11:38:32.643933,0,5089,3.0,10,0.2
2025-08-18T11:38:33.144868,0,5089,3.0,10,0.1
2025-08-18T11:38:33.645720,0,5089,3.0,10,0.1
2025-08-18T11:38:34.146568,0,5089,3.0,10,0.1
2025-08-18T11:38:34.647414,0,5089,3.0,10,0.2
2025-08-18T11:38:35.148223,0,5089,3.0,10,0.2
2025-08-18T11:38:35.649047,0,5089,3.0,10,0.2
2025-08-18T11:38:36.149883,0,5089,3.0,10,0.1
2025-08-18T11:38:36.650769,0,5089,3.0,10,0.2
2025-08-18T11:38:37.151559,0,5089,3.0,10,0.1
2025-08-18T11:38:37.652289,0,5089,3.0,10,0.1
2025-08-18T11:38:38.153054,0,5089,3.0,10,0.1
2025-08-18T11:38:38.653855,0,5089,3.0,10,0.2
2025-08-18T11:38:39.154717,0,5089,3.0,10,0.2
2025-08-18T11:38:39.655290,0,5089,3.0,10,0.8
2025-08-18T11:38:40.156002,0,5089,3.0,10,0.5
2025-08-18T11:38:40.656714,0,5089,3.0,10,1.8
2025-08-18T11:38:41.157437,0,5089,3.0,10,0.6
2025-08-18T11:38:41.658070,0,5089,3.0,10,0.4
2025-08-18T11:38:42.158877,0,5089,3.0,10,0.1
2025-08-18T11:38:42.659709,0,5089,3.0,10,0.1
2025-08-18T11:38:43.160480,0,5089,3.0,10,0.2
2025-08-18T11:38:43.661326,0,5089,3.0,10,0.2
2025-08-18T11:38:44.162289,0,5089,3.0,10,0.1
2025-08-18T11:38:44.663112,0,5089,3.0,10,0.2
2025-08-18T11:38:45.163949,0,5089,3.0,10,0.2
2025-08-18T11:38:45.664778,0,5089,3.0,10,0.1
2025-08-18T11:38:46.165651,0,5089,3.0,10,0.0
2025-08-18T11:38:46.666363,0,5089,3.0,10,0.2
2025-08-18T11:38:47.167157,0,5089,3.0,10,0.1
2025-08-18T11:38:47.668005,0,5089,3.0,10,0.1
2025-08-18T11:38:48.168839,0,5089,3.0,10,0.4
2025-08-18T11:38:48.669752,0,5089,3.0,10,0.2
2025-08-18T11:38:49.170506,0,5089,3.0,10,0.3
2025-08-18T11:38:49.671292,0,5089,3.0,10,0.2
2025-08-18T11:38:50.172077,0,5089,3.0,10,0.1
2025-08-18T11:38:50.672909,0,5089,3.0,10,0.1
2025-08-18T11:38:51.173670,0,5089,3.0,10,0.1
2025-08-18T11:38:51.674424,0,5089,3.0,10,0.2
2025-08-18T11:38:52.175171,0,5089,3.0,10,0.1
2025-08-18T11:38:52.675987,0,5089,3.0,10,0.2
2025-08-18T11:38:53.176832,0,5089,3.0,10,0.2
2025-08-18T11:38:53.677668,0,5089,3.0,10,0.1
2025-08-18T11:38:54.178483,0,5089,3.0,10,0.2
2025-08-18T11:38:54.679377,0,5089,3.0,10,0.2
2025-08-18T11:38:55.180154,0,5089,3.0,10,0.1
2025-08-18T11:38:55.681000,0,5089,3.0,10,0.2
2025-08-18T11:38:56.181913,0,5089,3.0,10,0.1
2025-08-18T11:38:56.682756,0,5089,3.0,10,0.1
2025-08-18T11:38:57.183563,0,5089,3.0,10,0.1
2025-08-18T11:38:57.684328,0,5089,3.0,10,0.2
2025-08-18T11:38:58.185110,0,5089,3.0,10,0.1
2025-08-18T11:38:58.685958,0,5089,3.0,10,0.9
2025-08-18T11:38:59.186728,0,5089,3.0,10,0.1
2025-08-18T11:38:59.687556,0,5089,3.0,10,1.7
2025-08-18T11:39:00.188240,0,5089,3.0,10,0.1
2025-08-18T11:39:00.688970,0,5089,3.0,10,0.3
2025-08-18T11:39:01.189806,0,5089,3.0,10,0.2
2025-08-18T11:39:01.690588,0,5089,3.0,10,0.2
2025-08-18T11:39:02.191341,0,5089,3.0,10,0.2
2025-08-18T11:39:02.692134,0,5089,3.0,10,0.1
2025-08-18T11:39:03.192948,0,5089,3.0,10,0.3
2025-08-18T11:39:03.693740,0,5089,3.0,10,0.3
2025-08-18T11:39:04.194566,0,5089,3.0,10,0.1
2025-08-18T11:39:04.695395,0,5089,3.0,10,0.2
2025-08-18T11:39:05.196193,0,5089,3.0,10,0.2
2025-08-18T11:39:05.697009,0,5089,3.0,10,0.1
2025-08-18T11:39:06.197818,0,5089,3.0,10,0.1
2025-08-18T11:39:06.698592,0,5089,3.0,10,0.2
2025-08-18T11:39:07.199328,0,5089,3.0,10,0.1
2025-08-18T11:39:07.700156,0,5089,3.0,10,0.1
2025-08-18T11:39:08.200997,0,5089,3.0,10,0.1
2025-08-18T11:39:08.701849,0,5089,3.0,10,0.1
2025-08-18T11:39:09.202661,0,5089,3.0,10,0.1
2025-08-18T11:39:09.703272,0,5089,3.0,10,0.5
2025-08-18T11:39:10.203899,0,5089,3.0,10,0.6
2025-08-18T11:39:10.704326,0,5089,3.0,10,2.1
2025-08-18T11:39:11.205063,0,5089,3.0,10,0.8
2025-08-18T11:39:11.705869,0,5089,3.0,10,0.1
2025-08-18T11:39:12.206653,0,5089,3.0,10,0.3
2025-08-18T11:39:12.707445,0,5089,3.0,10,0.1
2025-08-18T11:39:13.208255,0,5089,3.0,10,0.2
2025-08-18T11:39:13.709001,0,5089,3.0,10,0.2
2025-08-18T11:39:14.209836,0,5089,3.0,10,0.1
2025-08-18T11:39:14.710714,0,5089,3.0,10,0.3
2025-08-18T11:39:15.211575,0,5089,3.0,10,0.1
2025-08-18T11:39:15.712406,0,5089,3.0,10,0.2
2025-08-18T11:39:16.213192,0,5089,3.0,10,0.2
2025-08-18T11:39:16.714012,0,5089,3.0,10,0.1
2025-08-18T11:39:17.214852,0,5089,3.0,10,0.1
2025-08-18T11:39:17.715675,0,5089,3.0,10,0.2
2025-08-18T11:39:18.216542,0,5089,3.0,10,0.2
2025-08-18T11:39:18.717311,0,5089,3.0,10,0.1
2025-08-18T11:39:19.218081,0,5089,3.0,10,0.3
2025-08-18T11:39:19.718902,0,5089,3.0,10,0.1
2025-08-18T11:39:20.219813,0,5089,3.0,10,0.1
2025-08-18T11:39:20.720635,0,5089,3.0,10,0.2
2025-08-18T11:39:21.221344,0,5089,3.0,10,0.1
2025-08-18T11:39:21.722172,0,5089,3.0,10,0.1
2025-08-18T11:39:22.222983,0,5089,3.0,10,0.2
2025-08-18T11:39:22.723762,0,5089,3.0,10,0.1
2025-08-18T11:39:23.224597,0,5089,3.0,10,0.1
2025-08-18T11:39:23.725349,0,5089,3.0,10,0.2
2025-08-18T11:39:24.226164,0,5089,3.0,10,0.2
2025-08-18T11:39:24.726939,0,5089,3.0,10,0.1
2025-08-18T11:39:25.227806,0,5089,3.0,10,0.1
2025-08-18T11:39:25.728674,0,5089,3.0,10,0.2
2025-08-18T11:39:26.229561,0,5089,3.0,10,0.1
2025-08-18T11:39:26.730320,0,5089,3.0,10,0.1
2025-08-18T11:39:27.231159,0,5089,3.0,10,0.2
2025-08-18T11:39:27.731984,0,5089,3.0,10,0.2
2025-08-18T11:39:28.232834,0,5089,3.0,10,0.1
2025-08-18T11:39:28.733798,0,5089,3.0,10,0.1
2025-08-18T11:39:29.234548,0,5089,3.0,10,0.1
2025-08-18T11:39:29.735202,0,5089,3.0,10,0.2
2025-08-18T11:39:30.236003,0,5089,3.0,10,0.2
2025-08-18T11:39:30.736708,0,5089,3.0,10,0.1
2025-08-18T11:39:31.237614,0,5089,3.0,10,0.1
2025-08-18T11:39:31.738265,0,5089,3.0,10,0.1
2025-08-18T11:39:32.239028,0,5089,3.0,10,0.1
2025-08-18T11:39:32.739681,0,5089,3.0,10,0.2
2025-08-18T11:39:33.240470,0,5089,3.0,10,0.1
2025-08-18T11:39:33.741309,0,5089,3.0,10,0.1
2025-08-18T11:39:34.242175,0,5089,3.0,10,0.2
2025-08-18T11:39:34.742999,0,5089,3.0,10,0.1
2025-08-18T11:39:35.243856,0,5089,3.0,10,0.1
2025-08-18T11:39:35.744760,0,5089,3.0,10,0.1
2025-08-18T11:39:36.245566,0,5089,3.0,10,0.2
2025-08-18T11:39:36.746308,0,5089,3.0,10,0.1
2025-08-18T11:39:37.247028,0,5089,3.0,10,0.1
2025-08-18T11:39:37.747925,0,5089,3.0,10,0.1
2025-08-18T11:39:38.248783,0,5089,3.0,10,0.2
2025-08-18T11:39:38.749638,0,5089,3.0,10,0.1
2025-08-18T11:39:39.250383,0,5089,3.0,10,0.2
2025-08-18T11:39:39.750662,0,5089,3.0,10,0.3
2025-08-18T11:39:40.251263,0,5089,3.0,10,0.7
2025-08-18T11:39:40.752147,0,5089,3.0,10,1.6
2025-08-18T11:39:41.252902,0,5089,3.0,10,1.4
2025-08-18T11:39:41.753799,0,5089,3.0,10,0.1
2025-08-18T11:39:42.254638,0,5089,3.0,10,0.4
2025-08-18T11:39:42.755438,0,5089,3.0,10,0.1
2025-08-18T11:39:43.256137,0,5089,3.0,10,0.2
2025-08-18T11:39:43.756943,0,5089,3.0,10,0.2
2025-08-18T11:39:44.257646,0,5089,3.0,10,0.1
2025-08-18T11:39:44.758321,0,5089,3.0,10,0.2
2025-08-18T11:39:45.259107,0,5089,3.0,10,0.2
2025-08-18T11:39:45.759980,0,5089,3.0,10,0.1
2025-08-18T11:39:46.260791,0,5089,3.0,10,0.1
2025-08-18T11:39:46.761611,0,5089,3.0,10,0.2
2025-08-18T11:39:47.262394,0,5089,3.0,10,0.1
2025-08-18T11:39:47.763182,0,5089,3.0,10,0.4
2025-08-18T11:39:48.263919,0,5089,3.0,10,0.5
2025-08-18T11:39:48.764662,0,5089,3.0,10,0.1
2025-08-18T11:39:49.265418,0,5089,3.0,10,0.3
2025-08-18T11:39:49.766201,0,5089,3.0,10,0.2
2025-08-18T11:39:50.267019,0,5089,3.0,10,0.1
2025-08-18T11:39:50.767785,0,5089,3.0,10,0.2
2025-08-18T11:39:51.268584,0,5089,3.0,10,0.2
2025-08-18T11:39:51.769416,0,5089,3.0,10,0.1
2025-08-18T11:39:52.270212,0,5089,3.0,10,0.1
2025-08-18T11:39:52.771035,0,5089,3.0,10,0.2
2025-08-18T11:39:53.271897,0,5089,3.0,10,0.1
2025-08-18T11:39:53.772735,0,5089,3.0,10,0.2
2025-08-18T11:39:54.273501,0,5089,3.0,10,0.1
2025-08-18T11:39:54.774426,0,5089,3.0,10,0.2
2025-08-18T11:39:55.275248,0,5089,3.0,10,0.2
2025-08-18T11:39:55.776097,0,5089,3.0,10,0.1
2025-08-18T11:39:56.276858,0,5089,3.0,10,0.1
2025-08-18T11:39:56.777713,0,5089,3.0,10,0.1
2025-08-18T11:39:57.278489,0,5089,3.0,10,0.2
2025-08-18T11:39:57.779361,0,5089,3.0,10,0.1
2025-08-18T11:39:58.280118,0,5089,3.0,10,0.2
2025-08-18T11:39:58.780911,0,5089,3.0,10,0.6
2025-08-18T11:39:59.281743,0,5089,3.0,10,0.3
2025-08-18T11:39:59.782599,0,5089,3.0,10,0.1
2025-08-18T11:40:00.283323,0,5089,3.0,10,0.1
2025-08-18T11:40:00.784114,0,5089,3.0,10,0.2
2025-08-18T11:40:01.284979,0,5089,3.0,10,0.2
2025-08-18T11:40:01.785773,0,5089,3.0,10,0.1
2025-08-18T11:40:02.286504,0,5089,3.0,10,0.2
2025-08-18T11:40:02.787362,0,5089,3.0,10,0.1
2025-08-18T11:40:03.288194,0,5089,3.0,10,0.5
2025-08-18T11:40:03.789000,0,5089,3.0,10,0.1
2025-08-18T11:40:04.289748,0,5089,3.0,10,0.2
2025-08-18T11:40:04.790474,0,5089,3.0,10,0.1
2025-08-18T11:40:05.291118,0,5089,3.0,10,0.2
2025-08-18T11:40:05.791958,0,5089,3.0,10,0.1
2025-08-18T11:40:06.292587,0,5089,3.0,10,0.3
2025-08-18T11:40:06.793278,0,5089,3.0,10,0.3
2025-08-18T11:40:07.293938,0,5089,3.0,10,0.1
2025-08-18T11:40:07.794631,0,5089,3.0,10,0.1
2025-08-18T11:40:08.295306,0,5089,3.0,10,0.1
2025-08-18T11:40:08.795982,0,5089,3.0,10,0.1
2025-08-18T11:40:09.296537,0,5089,3.0,10,0.2
2025-08-18T11:40:09.797194,0,5089,3.0,10,0.1
2025-08-18T11:40:10.297991,0,5089,3.0,10,2.5
2025-08-18T11:40:10.798572,0,5089,3.0,10,1.4
2025-08-18T11:40:11.299229,0,5089,3.0,10,1.6
2025-08-18T11:40:11.800020,0,5089,3.0,10,0.1
2025-08-18T11:40:12.300815,0,5089,3.0,10,0.4
2025-08-18T11:40:12.801570,0,5089,3.0,10,0.2
2025-08-18T11:40:13.302295,0,5089,3.0,10,0.2
2025-08-18T11:40:13.803085,0,5089,3.0,10,0.1
2025-08-18T11:40:14.303818,0,5089,3.0,10,0.2
2025-08-18T11:40:14.804487,0,5089,3.0,10,0.2
2025-08-18T11:40:15.305109,0,5089,3.0,10,0.2
2025-08-18T11:40:15.805876,0,5089,3.0,10,0.1
2025-08-18T11:40:16.306637,0,5089,3.0,10,0.2
2025-08-18T11:40:16.807342,0,5089,3.0,10,0.2
2025-08-18T11:40:17.308085,0,5089,3.0,10,0.1
2025-08-18T11:40:17.808804,0,5089,3.0,10,0.2
2025-08-18T11:40:18.309592,0,5089,3.0,10,0.1
2025-08-18T11:40:18.810271,0,5089,3.0,10,0.1
2025-08-18T11:40:19.310971,0,5089,3.0,10,0.3
2025-08-18T11:40:19.811730,0,5089,3.0,10,0.1
2025-08-18T11:40:20.312496,0,5089,3.0,10,0.2
2025-08-18T11:40:20.813267,0,5089,3.0,10,0.1
2025-08-18T11:40:21.313998,0,5089,3.0,10,0.1
2025-08-18T11:40:21.814726,0,5089,3.0,10,0.1
2025-08-18T11:40:22.315468,0,5089,3.0,10,0.2
2025-08-18T11:40:22.816281,0,5089,3.0,10,0.1
2025-08-18T11:40:23.317014,0,5089,3.0,10,0.2
2025-08-18T11:40:23.817728,0,5089,3.0,10,0.1
2025-08-18T11:40:24.318413,0,5089,3.0,10,0.3
2025-08-18T11:40:24.819071,0,5089,3.0,10,0.2
2025-08-18T11:40:25.319776,0,5089,3.0,10,0.1
2025-08-18T11:40:25.820397,0,5089,3.0,10,0.1
2025-08-18T11:40:26.321029,0,5089,3.0,10,0.1
2025-08-18T11:40:26.821643,0,5089,3.0,10,0.1
2025-08-18T11:40:27.322260,0,5089,3.0,10,0.2
2025-08-18T11:40:27.822948,0,5089,3.0,10,0.1
2025-08-18T11:40:28.323621,0,5089,3.0,10,0.1
2025-08-18T11:40:28.824187,0,5089,3.0,10,0.2
2025-08-18T11:40:29.324872,0,5089,3.0,10,0.1
2025-08-18T11:40:29.825451,0,5089,3.0,10,0.1
2025-08-18T11:40:30.326179,0,5089,3.0,10,0.1
2025-08-18T11:40:30.826945,0,5089,3.0,10,0.2
2025-08-18T11:40:31.327692,0,5089,3.0,10,0.1
2025-08-18T11:40:31.828451,0,5089,3.0,10,0.2
2025-08-18T11:40:32.329123,0,5089,3.0,10,0.1
2025-08-18T11:40:32.829813,0,5089,3.0,10,0.1
2025-08-18T11:40:33.330543,0,5089,3.0,10,0.1
2025-08-18T11:40:33.831232,0,5089,3.0,10,0.2
2025-08-18T11:40:34.331810,0,5089,3.0,10,0.1
2025-08-18T11:40:34.832475,0,5089,3.0,10,0.1
2025-08-18T11:40:35.333236,0,5089,3.0,10,0.1
2025-08-18T11:40:35.833988,0,5089,3.0,10,0.1
2025-08-18T11:40:36.334679,0,5089,3.0,10,0.1
2025-08-18T11:40:36.835385,0,5089,3.0,10,0.1
2025-08-18T11:40:37.336039,0,5089,3.0,10,0.2
2025-08-18T11:40:37.836694,0,5089,3.0,10,0.1
2025-08-18T11:40:38.337396,0,5089,3.0,10,0.1
2025-08-18T11:40:38.838144,0,5089,3.0,10,0.1
2025-08-18T11:40:39.338837,0,5089,3.0,10,0.3
2025-08-18T11:40:39.839621,0,5089,3.0,10,0.2
2025-08-18T11:40:40.340282,0,5089,3.0,10,0.6
2025-08-18T11:40:40.840849,0,5089,3.0,10,0.9
2025-08-18T11:40:41.341416,0,5089,3.0,10,1.8
2025-08-18T11:40:41.842114,0,5089,3.0,10,0.1
2025-08-18T11:40:42.342947,0,5089,3.0,10,0.4
2025-08-18T11:40:42.843679,0,5089,3.0,10,0.1
2025-08-18T11:40:43.344411,0,5089,3.0,10,0.1
2025-08-18T11:40:43.845090,0,5089,3.0,10,0.2
2025-08-18T11:40:44.345830,0,5089,3.0,10,0.2
2025-08-18T11:40:44.846578,0,5089,3.0,10,0.2
2025-08-18T11:40:45.347278,0,5089,3.0,10,0.1
2025-08-18T11:40:45.847996,0,5089,3.0,10,0.1
2025-08-18T11:40:46.348728,0,5089,3.0,10,0.1
2025-08-18T11:40:46.849414,0,5089,3.0,10,0.2
2025-08-18T11:40:47.350194,0,5089,3.0,10,0.1
2025-08-18T11:40:47.850954,0,5089,3.0,10,0.1
2025-08-18T11:40:48.351641,0,5089,3.0,10,3.6
2025-08-18T11:40:48.852330,0,5089,3.0,10,0.2
2025-08-18T11:40:49.353047,0,5089,3.0,10,0.8
2025-08-18T11:40:49.853818,0,5089,3.0,10,0.3
2025-08-18T11:40:50.354561,0,5089,3.0,10,0.1
2025-08-18T11:40:50.855309,0,5089,3.0,10,0.2
2025-08-18T11:40:51.356303,0,5089,3.0,10,0.3
2025-08-18T11:40:51.856988,0,5089,3.0,10,0.1
2025-08-18T11:40:52.357805,0,5089,3.0,10,0.2
2025-08-18T11:40:52.858604,0,5089,3.0,10,2.0
2025-08-18T11:40:53.359383,0,5089,3.0,10,0.2
2025-08-18T11:40:53.860152,0,5089,3.0,10,0.2
2025-08-18T11:40:54.360909,0,5089,3.0,10,0.2
2025-08-18T11:40:54.861744,0,5089,3.0,10,0.2
2025-08-18T11:40:55.362440,0,5089,3.0,10,0.1
2025-08-18T11:40:55.863243,0,5089,3.0,10,0.2
2025-08-18T11:40:56.364053,0,5089,3.0,10,0.2
2025-08-18T11:40:56.864792,0,5089,3.0,10,0.2
2025-08-18T11:40:57.365564,0,5089,3.0,10,0.1
2025-08-18T11:40:57.866343,0,5089,3.0,10,0.2
2025-08-18T11:40:58.367095,0,5089,3.0,10,0.4
2025-08-18T11:40:58.867852,0,5089,3.0,10,0.7
2025-08-18T11:40:59.368584,0,5089,3.0,10,0.5
2025-08-18T11:40:59.869303,0,5089,3.0,10,0.2
2025-08-18T11:41:00.370077,0,5089,3.0,10,0.1
2025-08-18T11:41:00.870810,0,5089,3.0,10,0.2
2025-08-18T11:41:01.371581,0,5089,3.0,10,0.2
2025-08-18T11:41:01.872324,0,5089,3.0,10,0.2
2025-08-18T11:41:02.373016,0,5089,3.0,10,0.1
2025-08-18T11:41:02.873763,0,5089,3.0,10,0.1
2025-08-18T11:41:03.374310,0,5089,3.0,10,0.3
2025-08-18T11:41:03.875046,0,5089,3.0,10,0.2
2025-08-18T11:41:04.375735,0,5089,3.0,10,0.1
2025-08-18T11:41:04.876476,0,5089,3.0,10,0.1
2025-08-18T11:41:05.377253,0,5089,3.0,10,0.2
2025-08-18T11:41:05.878102,0,5089,3.0,10,0.1
2025-08-18T11:41:06.378950,0,5089,3.0,10,0.1
2025-08-18T11:41:06.879825,0,5089,3.0,10,0.2
2025-08-18T11:41:07.380649,0,5089,3.0,10,0.1
2025-08-18T11:41:07.881424,0,5089,3.0,10,0.1
2025-08-18T11:41:08.382240,0,5089,3.0,10,0.2
2025-08-18T11:41:08.883011,0,5089,3.0,10,0.2
2025-08-18T11:41:09.383697,0,5089,3.0,10,0.1
2025-08-18T11:41:09.884560,0,5089,3.0,10,0.1
2025-08-18T11:41:10.385204,0,5089,3.0,10,0.8
2025-08-18T11:41:10.885782,0,5089,3.0,10,0.9
2025-08-18T11:41:11.386393,0,5089,3.0,10,1.9
2025-08-18T11:41:11.887087,0,5089,3.0,10,0.5
2025-08-18T11:41:12.387890,0,5089,3.0,10,0.3
2025-08-18T11:41:12.888680,0,5089,3.0,10,0.2
2025-08-18T11:41:13.389451,0,5089,3.0,10,0.1
2025-08-18T11:41:13.890180,0,5089,3.0,10,0.2
2025-08-18T11:41:14.390903,0,5089,3.0,10,0.2
2025-08-18T11:41:14.891757,0,5089,3.0,10,0.1
2025-08-18T11:41:15.392611,0,5089,3.0,10,0.1
2025-08-18T11:41:15.893419,0,5089,3.0,10,0.2
2025-08-18T11:41:16.394225,0,5089,3.0,10,0.2
2025-08-18T11:41:16.895053,0,5089,3.0,10,0.2
2025-08-18T11:41:17.395829,0,5089,3.0,10,0.2
2025-08-18T11:41:17.896578,0,5089,3.0,10,0.1
2025-08-18T11:41:18.397426,0,5089,3.0,10,0.1
2025-08-18T11:41:18.898138,0,5089,3.0,10,0.2
2025-08-18T11:41:19.398922,0,5089,3.0,10,0.2
2025-08-18T11:41:19.899716,0,5089,3.0,10,0.1
2025-08-18T11:41:20.400450,0,5089,3.0,10,0.2
2025-08-18T11:41:20.901249,0,5089,3.0,10,0.1
2025-08-18T11:41:21.402031,0,5089,3.0,10,0.1
2025-08-18T11:41:21.902861,0,5089,3.0,10,0.1
2025-08-18T11:41:22.403692,0,5089,3.0,10,0.1
2025-08-18T11:41:22.904499,0,5089,3.0,10,0.1
2025-08-18T11:41:23.405307,0,5089,3.0,10,0.1
2025-08-18T11:41:23.906076,0,5089,3.0,10,0.1
2025-08-18T11:41:24.406913,0,5089,3.0,10,0.2
2025-08-18T11:41:24.907760,0,5089,3.0,10,0.1
2025-08-18T11:41:25.408654,0,5089,3.0,10,0.1
2025-08-18T11:41:25.909584,0,5089,3.0,10,0.2
2025-08-18T11:41:26.410286,0,5089,3.0,10,0.1
2025-08-18T11:41:26.910928,0,5089,3.0,10,0.1
2025-08-18T11:41:27.411695,0,5089,3.0,10,0.1
2025-08-18T11:41:27.912399,0,5089,3.0,10,0.2
2025-08-18T11:41:28.413123,0,5089,3.0,10,0.1
2025-08-18T11:41:28.913938,0,5089,3.0,10,0.1
2025-08-18T11:41:29.414705,0,5089,3.0,10,0.2
2025-08-18T11:41:29.915494,0,5089,3.0,10,0.1
2025-08-18T11:41:30.416232,0,5089,3.0,10,0.1
2025-08-18T11:41:30.917008,0,5089,3.0,10,0.2
2025-08-18T11:41:31.417752,0,5089,3.0,10,0.1
2025-08-18T11:41:31.918460,0,5089,3.0,10,0.1
2025-08-18T11:41:32.419242,0,5089,3.0,10,0.1
2025-08-18T11:41:32.920002,0,5089,3.0,10,0.1
2025-08-18T11:41:33.420731,0,5089,3.0,10,0.1
2025-08-18T11:41:33.921442,0,5089,3.0,10,0.2
2025-08-18T11:41:34.422264,0,5089,3.0,10,0.2
2025-08-18T11:41:34.923042,0,5089,3.0,10,0.1
2025-08-18T11:41:35.423718,0,5089,3.0,10,0.1
2025-08-18T11:41:35.924279,0,5089,3.0,10,0.2
2025-08-18T11:41:36.424989,0,5089,3.0,10,0.1
2025-08-18T11:41:36.925785,0,5089,3.0,10,0.1
2025-08-18T11:41:37.426497,0,5089,3.0,10,0.1
2025-08-18T11:41:37.927219,0,5089,3.0,10,0.2
2025-08-18T11:41:38.427952,0,5089,3.0,10,0.1
2025-08-18T11:41:38.928538,0,5089,3.0,10,0.1
2025-08-18T11:41:39.429244,0,5089,3.0,10,0.3
2025-08-18T11:41:39.929961,0,5089,3.0,10,0.1
2025-08-18T11:41:40.430489,0,5089,3.0,10,0.9
2025-08-18T11:41:40.931061,0,5089,3.0,10,0.6
2025-08-18T11:41:41.431642,0,5089,3.0,10,1.6
2025-08-18T11:41:41.932341,0,5089,3.0,10,0.6
2025-08-18T11:41:42.433025,0,5089,3.0,10,0.3
2025-08-18T11:41:42.933820,0,5089,3.0,10,0.1
2025-08-18T11:41:43.434717,0,5089,3.0,10,0.1
2025-08-18T11:41:43.935380,0,5089,3.0,10,0.1
2025-08-18T11:41:44.436100,0,5089,3.0,10,0.2
2025-08-18T11:41:44.936853,0,5089,3.0,10,0.2
2025-08-18T11:41:45.437446,0,5089,3.0,10,0.1
2025-08-18T11:41:45.938038,0,5089,3.0,10,0.1
2025-08-18T11:41:46.438830,0,5089,3.0,10,0.1
2025-08-18T11:41:46.939387,0,5089,3.0,10,0.1
2025-08-18T11:41:47.440010,0,5089,3.0,10,0.1
2025-08-18T11:41:47.940704,0,5089,3.0,10,0.1
2025-08-18T11:41:48.441393,0,5089,3.0,10,0.3
2025-08-18T11:41:48.941748,0,5089,3.0,10,0.3
2025-08-18T11:41:49.442382,0,5089,3.0,10,0.4
2025-08-18T11:41:49.943092,0,5089,3.0,10,0.1
2025-08-18T11:41:50.443873,0,5089,3.0,10,0.2
2025-08-18T11:41:50.944603,0,5089,3.0,10,0.1
2025-08-18T11:41:51.445373,0,5089,3.0,10,0.1
2025-08-18T11:41:51.946031,0,5089,3.0,10,0.1
2025-08-18T11:41:52.446760,0,5089,3.0,10,0.1
2025-08-18T11:41:52.947362,0,5089,3.0,10,0.1
2025-08-18T11:41:53.448100,0,5089,3.0,10,0.1
2025-08-18T11:41:53.948892,0,5089,3.0,10,0.2
2025-08-18T11:41:54.449747,0,5089,3.0,10,0.2
2025-08-18T11:41:54.950614,0,5089,3.0,10,0.1
2025-08-18T11:41:55.451419,0,5089,3.0,10,0.1
2025-08-18T11:41:55.952244,0,5089,3.0,10,0.2
2025-08-18T11:41:56.453096,0,5089,3.0,10,0.2
2025-08-18T11:41:56.953906,0,5089,3.0,10,0.2
2025-08-18T11:41:57.454748,0,5089,3.0,10,0.1
2025-08-18T11:41:57.955370,0,5089,3.0,10,0.2
2025-08-18T11:41:58.456098,0,5089,3.0,10,0.1
2025-08-18T11:41:58.956981,0,5089,3.0,10,0.7
2025-08-18T11:41:59.457806,0,5089,3.0,10,0.3
2025-08-18T11:41:59.958647,0,5089,3.0,10,0.1
2025-08-18T11:42:00.459433,0,5089,3.0,10,0.2
2025-08-18T11:42:00.960294,0,5089,3.0,10,0.3
2025-08-18T11:42:01.461106,0,5089,3.0,10,0.1
2025-08-18T11:42:01.961902,0,5089,3.0,10,0.2
2025-08-18T11:42:02.462695,0,5089,3.0,10,0.1
2025-08-18T11:42:02.963561,0,5089,3.0,10,2.2
2025-08-18T11:42:03.464372,0,5089,3.0,10,0.6
2025-08-18T11:42:03.965119,0,5089,3.0,10,0.2
2025-08-18T11:42:04.465906,0,5089,3.0,10,0.3
2025-08-18T11:42:04.966723,0,5089,3.0,10,0.1
2025-08-18T11:42:05.467481,0,5089,3.0,10,0.2
2025-08-18T11:42:05.968292,0,5089,3.0,10,0.1
2025-08-18T11:42:06.469041,0,5089,3.0,10,0.1
2025-08-18T11:42:06.969873,0,5089,3.0,10,0.1
2025-08-18T11:42:07.470672,0,5089,3.0,10,0.2
2025-08-18T11:42:07.971453,0,5089,3.0,10,0.1
2025-08-18T11:42:08.472260,0,5089,3.0,10,0.2
2025-08-18T11:42:08.973048,0,5089,3.0,10,0.2
2025-08-18T11:42:09.473857,0,5089,3.0,10,0.1
2025-08-18T11:42:09.974665,0,5089,3.0,10,0.1
2025-08-18T11:42:10.475216,0,5089,3.0,10,0.5
2025-08-18T11:42:10.975811,0,5089,3.0,10,0.7
2025-08-18T11:42:11.476337,0,5089,3.0,10,1.9
2025-08-18T11:42:11.976983,0,5089,3.0,10,0.9
2025-08-18T11:42:12.477699,0,5089,3.0,10,0.2
2025-08-18T11:42:12.978399,0,5089,3.0,10,0.3
2025-08-18T11:42:13.479117,0,5089,3.0,10,0.1
2025-08-18T11:42:13.979936,0,5089,3.0,10,0.1
2025-08-18T11:42:14.480726,0,5089,3.0,10,0.1
2025-08-18T11:42:14.981469,0,5089,3.0,10,0.2
2025-08-18T11:42:15.482183,0,5089,3.0,10,0.2
2025-08-18T11:42:15.982883,0,5089,3.0,10,0.1
2025-08-18T11:42:16.483632,0,5089,3.0,10,0.2
2025-08-18T11:42:16.984406,0,5089,3.0,10,0.1
2025-08-18T11:42:17.485093,0,5089,3.0,10,0.2
2025-08-18T11:42:17.985825,0,5089,3.0,10,0.1
2025-08-18T11:42:18.486547,0,5089,3.0,10,0.1
2025-08-18T11:42:18.987231,0,5089,3.0,10,0.1
2025-08-18T11:42:19.487965,0,5089,3.0,10,0.3
2025-08-18T11:42:19.988742,0,5089,3.0,10,0.1
2025-08-18T11:42:20.489332,0,5089,3.0,10,0.1
2025-08-18T11:42:20.990045,0,5089,3.0,10,0.2
2025-08-18T11:42:21.490838,0,5089,3.0,10,0.2
2025-08-18T11:42:21.991597,0,5089,3.0,10,0.1
2025-08-18T11:42:22.492347,0,5089,3.0,10,0.1
2025-08-18T11:42:22.993015,0,5089,3.0,10,0.2
2025-08-18T11:42:23.493757,0,5089,3.0,10,0.1
2025-08-18T11:42:23.994568,0,5089,3.0,10,0.1
2025-08-18T11:42:24.495299,0,5089,3.0,10,0.2
2025-08-18T11:42:24.995992,0,5089,3.0,10,0.1
2025-08-18T11:42:25.496756,0,5089,3.0,10,0.2
2025-08-18T11:42:25.997615,0,5089,3.0,10,0.1
2025-08-18T11:42:26.498410,0,5089,3.0,10,0.1
2025-08-18T11:42:26.999270,0,5089,3.0,10,0.1
2025-08-18T11:42:27.500125,0,5089,3.0,10,0.1
2025-08-18T11:42:28.000986,0,5089,3.0,10,0.2
2025-08-18T11:42:28.501781,0,5089,3.0,10,0.1
2025-08-18T11:42:29.002592,0,5089,3.0,10,0.1
2025-08-18T11:42:29.503402,0,5089,3.0,10,0.1
2025-08-18T11:42:30.004263,0,5089,3.0,10,0.1
2025-08-18T11:42:30.505061,0,5089,3.0,10,0.1
2025-08-18T11:42:31.005916,0,5089,3.0,10,0.1
2025-08-18T11:42:31.506732,0,5089,3.0,10,0.1
2025-08-18T11:42:32.007487,0,5089,3.0,10,0.1
2025-08-18T11:42:32.508376,0,5089,3.0,10,0.1
2025-08-18T11:42:33.009144,0,5089,3.0,10,0.3
2025-08-18T11:42:33.509911,0,5089,3.0,10,0.2
2025-08-18T11:42:34.010692,0,5089,3.0,10,0.1
2025-08-18T11:42:34.511359,0,5089,3.0,10,0.2
2025-08-18T11:42:35.012139,0,5089,3.0,10,0.1
2025-08-18T11:42:35.512949,0,5089,3.0,10,0.2
2025-08-18T11:42:36.013729,0,5089,3.0,10,0.1
2025-08-18T11:42:36.514559,0,5089,3.0,10,0.1
2025-08-18T11:42:37.015387,0,5089,3.0,10,0.1
2025-08-18T11:42:37.516170,0,5089,3.0,10,0.1
2025-08-18T11:42:38.016994,0,5089,3.0,10,0.1
2025-08-18T11:42:38.517758,0,5089,3.0,10,0.1
2025-08-18T11:42:39.018405,0,5089,3.0,10,0.1
2025-08-18T11:42:39.519041,0,5089,3.0,10,0.3
2025-08-18T11:42:40.019710,0,5089,3.0,10,0.1
2025-08-18T11:42:40.520384,0,5089,3.0,10,0.2
2025-08-18T11:42:41.021139,0,5089,3.0,10,0.7
2025-08-18T11:42:41.521765,0,5089,3.0,10,1.4
2025-08-18T11:42:42.022374,0,5089,3.0,10,1.7
2025-08-18T11:42:42.523133,0,5089,3.0,10,0.1
2025-08-18T11:42:43.023923,0,5089,3.0,10,0.4
2025-08-18T11:42:43.524785,0,5089,3.0,10,0.1
2025-08-18T11:42:44.025604,0,5089,3.0,10,0.2
2025-08-18T11:42:44.526447,0,5089,3.0,10,0.2
2025-08-18T11:42:45.027326,0,5089,3.0,10,0.2
2025-08-18T11:42:45.528195,0,5089,3.0,10,0.1
2025-08-18T11:42:46.029021,0,5089,3.0,10,0.2
2025-08-18T11:42:46.529905,0,5089,3.0,10,0.1
2025-08-18T11:42:47.030657,0,5089,3.0,10,0.2
2025-08-18T11:42:47.531581,0,5089,3.0,10,0.2
2025-08-18T11:42:48.032409,0,5089,3.0,10,0.1
2025-08-18T11:42:48.533277,0,5089,3.0,10,0.3
2025-08-18T11:42:49.034069,0,5089,3.0,10,0.3
2025-08-18T11:42:49.534985,0,5089,3.0,10,0.3
2025-08-18T11:42:50.035730,0,5089,3.0,10,0.1
2025-08-18T11:42:50.536666,0,5089,3.0,10,0.2
2025-08-18T11:42:51.037380,0,5089,3.0,10,0.2
2025-08-18T11:42:51.538101,0,5089,3.0,10,0.2
2025-08-18T11:42:52.038756,0,5089,3.0,10,0.1
2025-08-18T11:42:52.539397,0,5089,3.0,10,0.1
2025-08-18T11:42:53.040135,0,5089,3.0,10,0.2
2025-08-18T11:42:53.540942,0,5089,3.0,10,0.1
2025-08-18T11:42:54.041748,0,5089,3.0,10,0.2
2025-08-18T11:42:54.542436,0,5089,3.0,10,0.1
2025-08-18T11:42:55.043115,0,5089,3.0,10,0.2
2025-08-18T11:42:55.543787,0,5089,3.0,10,0.1
2025-08-18T11:42:56.044474,0,5089,3.0,10,0.1
2025-08-18T11:42:56.545173,0,5089,3.0,10,0.2
2025-08-18T11:42:57.045956,0,5089,3.0,10,0.2
2025-08-18T11:42:57.546721,0,5089,3.0,10,0.1
2025-08-18T11:42:58.047348,0,5089,3.0,10,0.1
2025-08-18T11:42:58.548013,0,5089,3.0,10,0.1
2025-08-18T11:42:59.048698,0,5089,3.0,10,0.7
2025-08-18T11:42:59.549339,0,5089,3.0,10,0.3
2025-08-18T11:43:00.050183,0,5089,3.0,10,0.2
2025-08-18T11:43:00.551033,0,5089,3.0,10,0.2
2025-08-18T11:43:01.051862,0,5089,3.0,10,0.2
2025-08-18T11:43:01.552655,0,5089,3.0,10,0.1
2025-08-18T11:43:02.053305,0,5089,3.0,10,0.1
2025-08-18T11:43:02.554106,0,5089,3.0,10,0.1
2025-08-18T11:43:03.054776,0,5089,3.0,10,0.3
2025-08-18T11:43:03.555440,0,5089,3.0,10,0.3
2025-08-18T11:43:04.056474,0,5089,3.0,10,0.1
2025-08-18T11:43:04.557393,0,5089,3.0,10,0.2
2025-08-18T11:43:05.058219,0,5089,3.0,10,0.2
2025-08-18T11:43:05.558911,0,5089,3.0,10,0.1
2025-08-18T11:43:06.059564,0,5089,3.0,10,0.1
2025-08-18T11:43:06.560578,0,5089,3.0,10,0.1
2025-08-18T11:43:07.061557,0,5089,3.0,10,0.1
2025-08-18T11:43:07.562300,0,5089,3.0,10,0.1
2025-08-18T11:43:08.062909,0,5089,3.0,10,0.1
2025-08-18T11:43:08.563770,0,5089,3.0,10,0.1
2025-08-18T11:43:09.064550,0,5089,3.0,10,0.2
2025-08-18T11:43:09.565329,0,5089,3.0,10,0.2
2025-08-18T11:43:10.066193,0,5089,3.0,10,0.2
2025-08-18T11:43:10.566852,0,5089,3.0,10,0.2
2025-08-18T11:43:11.067582,0,5089,3.0,10,2.6
2025-08-18T11:43:11.568161,0,5089,3.0,10,1.4
2025-08-18T11:43:12.068883,0,5089,3.0,10,1.7
2025-08-18T11:43:12.569599,0,5089,3.0,10,0.2
2025-08-18T11:43:13.070404,0,5089,3.0,10,0.3
2025-08-18T11:43:13.571111,0,5089,3.0,10,0.1
2025-08-18T11:43:14.071895,0,5089,3.0,10,0.2
2025-08-18T11:43:14.572639,0,5089,3.0,10,0.2
2025-08-18T11:43:15.073474,0,5089,3.0,10,0.2
2025-08-18T11:43:15.574324,0,5089,3.0,10,0.2
2025-08-18T11:43:16.075150,0,5089,3.0,10,0.2
2025-08-18T11:43:16.575951,0,5089,3.0,10,0.2
2025-08-18T11:43:17.076791,0,5089,3.0,10,0.1
2025-08-18T11:43:17.577667,0,5089,3.0,10,0.1
2025-08-18T11:43:18.078384,0,5089,3.0,10,0.2
2025-08-18T11:43:18.579222,0,5089,3.0,10,0.1
2025-08-18T11:43:19.080037,0,5089,3.0,10,0.1
2025-08-18T11:43:19.580863,0,5089,3.0,10,0.2
2025-08-18T11:43:20.081667,0,5089,3.0,10,0.2
2025-08-18T11:43:20.582455,0,5089,3.0,10,0.1
2025-08-18T11:43:21.083317,0,5089,3.0,10,0.1
2025-08-18T11:43:21.584139,0,5089,3.0,10,0.2
2025-08-18T11:43:22.084967,0,5089,3.0,10,0.2
2025-08-18T11:43:22.585794,0,5089,3.0,10,0.1
2025-08-18T11:43:23.086666,0,5089,3.0,10,0.1
2025-08-18T11:43:23.587446,0,5089,3.0,10,0.1
2025-08-18T11:43:24.088401,0,5089,3.0,10,0.2
2025-08-18T11:43:24.589302,0,5089,3.0,10,0.2
2025-08-18T11:43:25.090081,0,5089,3.0,10,0.2
2025-08-18T11:43:25.590873,0,5089,3.0,10,0.2
2025-08-18T11:43:26.091719,0,5089,3.0,10,0.1
2025-08-18T11:43:26.592409,0,5089,3.0,10,0.2
2025-08-18T11:43:27.093263,0,5089,3.0,10,0.1
2025-08-18T11:43:27.594088,0,5089,3.0,10,0.1
2025-08-18T11:43:28.094959,0,5089,3.0,10,0.1
2025-08-18T11:43:28.595835,0,5089,3.0,10,0.1
2025-08-18T11:43:29.096703,0,5089,3.0,10,0.1
2025-08-18T11:43:29.597498,0,5089,3.0,10,0.2
2025-08-18T11:43:30.098374,0,5089,3.0,10,0.1
2025-08-18T11:43:30.599226,0,5089,3.0,10,0.2
2025-08-18T11:43:31.100031,0,5089,3.0,10,0.1
2025-08-18T11:43:31.600726,0,5089,3.0,10,0.1
2025-08-18T11:43:32.101600,0,5089,3.0,10,0.1
2025-08-18T11:43:32.602315,0,5089,3.0,10,0.1
2025-08-18T11:43:33.103149,0,5089,3.0,10,0.1
2025-08-18T11:43:33.604030,0,5089,3.0,10,0.1
2025-08-18T11:43:34.104846,0,5089,3.0,10,0.1
2025-08-18T11:43:34.605571,0,5089,3.0,10,0.1
2025-08-18T11:43:35.106383,0,5089,3.0,10,0.1
2025-08-18T11:43:35.607132,0,5089,3.0,10,0.1
2025-08-18T11:43:36.107963,0,5089,3.0,10,0.2
2025-08-18T11:43:36.608813,0,5089,3.0,10,0.2
2025-08-18T11:43:37.109674,0,5089,3.0,10,0.1
2025-08-18T11:43:37.610577,0,5089,3.0,10,0.1
2025-08-18T11:43:38.111387,0,5089,3.0,10,0.1
2025-08-18T11:43:38.612162,0,5089,3.0,10,0.1
2025-08-18T11:43:39.112990,0,5089,3.0,10,0.2
2025-08-18T11:43:39.613718,0,5089,3.0,10,0.2
2025-08-18T11:43:40.114443,0,5089,3.0,10,0.2
2025-08-18T11:43:40.615223,0,5089,3.0,10,0.1
2025-08-18T11:43:41.115932,0,5089,3.0,10,0.9
2025-08-18T11:43:41.616479,0,5089,3.0,10,0.9
2025-08-18T11:43:42.117036,0,5089,3.0,10,1.6
2025-08-18T11:43:42.617731,0,5089,3.0,10,0.3
2025-08-18T11:43:43.118401,0,5089,3.0,10,0.4
2025-08-18T11:43:43.619134,0,5089,3.0,10,0.1
2025-08-18T11:43:44.119838,0,5089,3.0,10,0.1
2025-08-18T11:43:44.620659,0,5089,3.0,10,0.2
2025-08-18T11:43:45.121394,0,5089,3.0,10,0.2
2025-08-18T11:43:45.622068,0,5089,3.0,10,0.1
2025-08-18T11:43:46.122846,0,5089,3.0,10,0.1
2025-08-18T11:43:46.623673,0,5089,3.0,10,0.2
2025-08-18T11:43:47.124535,0,5089,3.0,10,0.2
2025-08-18T11:43:47.625259,0,5089,3.0,10,0.2
2025-08-18T11:43:48.125861,0,5089,3.0,10,0.2
2025-08-18T11:43:48.626604,0,5089,3.0,10,0.2
2025-08-18T11:43:49.127335,0,5089,3.0,10,0.3
2025-08-18T11:43:49.627972,0,5089,3.0,10,0.2
2025-08-18T11:43:50.128762,0,5089,3.0,10,0.1
2025-08-18T11:43:50.629533,0,5089,3.0,10,0.2
2025-08-18T11:43:51.130292,0,5089,3.0,10,0.2
2025-08-18T11:43:51.631060,0,5089,3.0,10,0.1
2025-08-18T11:43:52.131823,0,5089,3.0,10,0.1
2025-08-18T11:43:52.632623,0,5089,3.0,10,0.1
2025-08-18T11:43:53.133371,0,5089,3.0,10,0.2
2025-08-18T11:43:53.634117,0,5089,3.0,10,0.2
2025-08-18T11:43:54.134836,0,5089,3.0,10,0.1
2025-08-18T11:43:54.635587,0,5089,3.0,10,0.2
2025-08-18T11:43:55.136358,0,5089,3.0,10,0.1
2025-08-18T11:43:55.637130,0,5089,3.0,10,0.1
2025-08-18T11:43:56.137860,0,5089,3.0,10,0.2
2025-08-18T11:43:56.638447,0,5089,3.0,10,0.2
2025-08-18T11:43:57.139211,0,5089,3.0,10,0.1
2025-08-18T11:43:57.639919,0,5089,3.0,10,0.1
2025-08-18T11:43:58.140689,0,5089,3.0,10,0.2
2025-08-18T11:43:58.641387,0,5089,3.0,10,0.1
2025-08-18T11:43:59.142131,0,5089,3.0,10,0.6
2025-08-18T11:43:59.642915,0,5089,3.0,10,0.2
2025-08-18T11:44:00.143730,0,5089,3.0,10,0.1
2025-08-18T11:44:00.644440,0,5089,3.0,10,0.1
2025-08-18T11:44:01.145111,0,5089,3.0,10,0.2
2025-08-18T11:44:01.645869,0,5089,3.0,10,0.2
2025-08-18T11:44:02.146623,0,5089,3.0,10,0.1
2025-08-18T11:44:02.647292,0,5089,3.0,10,0.1
2025-08-18T11:44:03.147957,0,5089,3.0,10,0.5
2025-08-18T11:44:03.648758,0,5089,3.0,10,0.2
2025-08-18T11:44:04.149591,0,5089,3.0,10,0.1
2025-08-18T11:44:04.650349,0,5089,3.0,10,0.2
2025-08-18T11:44:05.151186,0,5089,3.0,10,0.2
2025-08-18T11:44:05.651923,0,5089,3.0,10,0.2
2025-08-18T11:44:06.152537,0,5089,3.0,10,0.1
2025-08-18T11:44:06.653258,0,5089,3.0,10,0.1
2025-08-18T11:44:07.153938,0,5089,3.0,10,0.2
2025-08-18T11:44:07.654741,0,5089,3.0,10,0.1
2025-08-18T11:44:08.155357,0,5089,3.0,10,0.2
2025-08-18T11:44:08.656063,0,5089,3.0,10,0.2
2025-08-18T11:44:09.156801,0,5089,3.0,10,0.1
2025-08-18T11:44:09.657463,0,5089,3.0,10,0.1
2025-08-18T11:44:10.158225,0,5089,3.0,10,0.1
2025-08-18T11:44:10.658952,0,5089,3.0,10,0.2
2025-08-18T11:44:11.159500,0,5089,3.0,10,0.8
2025-08-18T11:44:11.660049,0,5089,3.0,10,0.8
2025-08-18T11:44:12.160644,0,5089,3.0,10,1.8
2025-08-18T11:44:12.661358,0,5089,3.0,10,0.4
2025-08-18T11:44:13.162089,0,5089,3.0,10,0.3
2025-08-18T11:44:13.662845,0,5089,3.0,10,0.1
2025-08-18T11:44:14.163682,0,5089,3.0,10,0.1
2025-08-18T11:44:14.664319,0,5089,3.0,10,0.2
2025-08-18T11:44:15.165027,0,5089,3.0,10,0.1
2025-08-18T11:44:15.665773,0,5089,3.0,10,0.1
2025-08-18T11:44:16.166357,0,5089,3.0,10,2.1
2025-08-18T11:44:16.666891,0,5089,3.0,10,1.2
2025-08-18T11:44:17.167639,0,5089,3.0,10,0.4
2025-08-18T11:44:17.668406,0,5089,3.0,10,0.4
2025-08-18T11:44:18.169152,0,5089,3.0,10,0.5
2025-08-18T11:44:18.670088,0,5089,3.0,10,0.3
2025-08-18T11:44:19.170839,0,5089,3.0,10,0.4
2025-08-18T11:44:19.671451,0,5089,3.0,10,2.4
2025-08-18T11:44:20.172052,0,5089,3.0,10,0.2
2025-08-18T11:44:20.672791,0,5089,3.0,10,0.4
2025-08-18T11:44:21.173422,0,5089,3.0,10,0.3
2025-08-18T11:44:21.674266,0,5089,3.0,10,0.3
2025-08-18T11:44:22.175037,0,5089,3.0,10,0.3
2025-08-18T11:44:22.676026,0,5089,3.0,10,0.3
2025-08-18T11:44:23.176773,0,5089,3.0,10,0.3
2025-08-18T11:44:23.677487,0,5089,3.0,10,0.3
2025-08-18T11:44:24.178274,0,5089,3.0,10,0.3
2025-08-18T11:44:24.679032,0,5089,3.0,10,0.3
2025-08-18T11:44:25.179847,0,5089,3.0,10,0.3
2025-08-18T11:44:25.680668,0,5089,3.0,10,0.3
2025-08-18T11:44:26.181378,0,5089,3.0,10,3.7
2025-08-18T11:44:26.682077,0,5089,3.0,10,0.1
2025-08-18T11:44:27.182788,0,5089,3.0,10,0.3
2025-08-18T11:44:27.683584,0,5089,3.0,10,0.1
2025-08-18T11:44:28.184249,0,5089,3.0,10,0.8
2025-08-18T11:44:28.685009,0,5089,3.0,10,0.1
2025-08-18T11:44:29.185793,0,5089,3.0,10,0.4
2025-08-18T11:44:29.686496,0,5089,3.0,10,0.1
2025-08-18T11:44:30.187203,0,5089,3.0,10,0.6
2025-08-18T11:44:30.687991,0,5089,3.0,10,0.3
2025-08-18T11:44:31.188678,0,5089,3.0,10,0.6
2025-08-18T11:44:31.689435,0,5089,3.0,10,0.2
2025-08-18T11:44:32.190039,0,5089,3.0,10,0.3
2025-08-18T11:44:32.690825,0,5089,3.0,10,0.1
2025-08-18T11:44:33.191537,0,5089,3.0,10,0.3
2025-08-18T11:44:33.692208,0,5089,3.0,10,0.2
2025-08-18T11:44:34.192967,0,5089,3.0,10,0.2
2025-08-18T11:44:34.693706,0,5089,3.0,10,0.2
2025-08-18T11:44:35.194341,0,5089,3.0,10,0.2
2025-08-18T11:44:35.695081,0,5089,3.0,10,0.3
2025-08-18T11:44:36.195991,0,5089,3.0,10,0.2
2025-08-18T11:44:36.696867,0,5089,3.0,10,0.2
2025-08-18T11:44:37.197739,0,5089,3.0,10,0.1
2025-08-18T11:44:37.698542,0,5089,3.0,10,0.1
2025-08-18T11:44:38.199374,0,5089,3.0,10,0.1
2025-08-18T11:44:38.700189,0,5089,3.0,10,0.1
2025-08-18T11:44:39.200979,0,5089,3.0,10,0.3
2025-08-18T11:44:39.701775,0,5089,3.0,10,0.1
2025-08-18T11:44:40.202485,0,5089,3.0,10,0.2
2025-08-18T11:44:40.703395,0,5089,3.0,10,0.1
2025-08-18T11:44:41.204128,0,5089,3.0,10,0.4
2025-08-18T11:44:41.704957,0,5089,3.0,10,0.2
2025-08-18T11:44:42.205765,0,5089,3.0,10,0.7
2025-08-18T11:44:42.706667,0,5089,3.0,10,0.2
2025-08-18T11:44:43.207372,0,5089,3.0,10,0.4
2025-08-18T11:44:43.708129,0,5089,3.0,10,0.1
2025-08-18T11:44:44.208984,0,5089,3.0,10,0.3
2025-08-18T11:44:44.709848,0,5089,3.0,10,0.1
2025-08-18T11:44:45.210662,0,5089,3.0,10,0.2
2025-08-18T11:44:45.711328,0,5089,3.0,10,0.1
2025-08-18T11:44:46.212125,0,5089,3.0,10,0.2
2025-08-18T11:44:46.712940,0,5089,3.0,10,0.2
2025-08-18T11:44:47.213605,0,5089,3.0,10,0.1
2025-08-18T11:44:47.714364,0,5089,3.0,10,0.2
2025-08-18T11:44:48.215112,0,5089,3.0,10,0.4
2025-08-18T11:44:48.715892,0,5089,3.0,10,0.2
2025-08-18T11:44:49.216651,0,5089,3.0,10,0.4
2025-08-18T11:44:49.717342,0,5089,3.0,10,0.2
2025-08-18T11:44:50.218144,0,5089,3.0,10,0.1
2025-08-18T11:44:50.718949,0,5089,3.0,10,0.1
2025-08-18T11:44:51.219627,0,5089,3.0,10,0.2
2025-08-18T11:44:51.720435,0,5089,3.0,10,0.1
2025-08-18T11:44:52.221158,0,5089,3.0,10,0.1
2025-08-18T11:44:52.721941,0,5089,3.0,10,0.2
2025-08-18T11:44:53.222707,0,5089,3.0,10,0.1
2025-08-18T11:44:53.723462,0,5089,3.0,10,0.2
2025-08-18T11:44:54.224170,0,5089,3.0,10,0.1
2025-08-18T11:44:54.724982,0,5089,3.0,10,0.2
2025-08-18T11:44:55.225666,0,5089,3.0,10,0.1
2025-08-18T11:44:55.726483,0,5089,3.0,10,0.1
2025-08-18T11:44:56.227184,0,5089,3.0,10,0.2
2025-08-18T11:44:56.727969,0,5089,3.0,10,0.1
2025-08-18T11:44:57.228790,0,5089,3.0,10,0.1
2025-08-18T11:44:57.729493,0,5089,3.0,10,0.1
2025-08-18T11:44:58.230155,0,5089,3.0,10,0.2
2025-08-18T11:44:58.730457,0,5089,3.0,10,0.4
2025-08-18T11:44:59.231104,0,5089,3.0,10,0.4
2025-08-18T11:44:59.731913,0,5089,3.0,10,0.2
2025-08-18T11:45:00.232586,0,5089,3.0,10,0.2
2025-08-18T11:45:00.733300,0,5089,3.0,10,0.1
2025-08-18T11:45:01.234033,0,5089,3.0,10,0.1
2025-08-18T11:45:01.734801,0,5089,3.0,10,0.2
2025-08-18T11:45:02.235441,0,5089,3.0,10,0.2
2025-08-18T11:45:02.736132,0,5089,3.0,10,0.1
2025-08-18T11:45:03.236919,0,5089,3.0,10,0.3
2025-08-18T11:45:03.737579,0,5089,3.0,10,1.9
2025-08-18T11:45:04.238244,0,5089,3.0,10,0.2
2025-08-18T11:45:04.738899,0,5089,3.0,10,0.1
2025-08-18T11:45:05.239495,0,5089,3.0,10,0.2
2025-08-18T11:45:05.740249,0,5089,3.0,10,0.1
2025-08-18T11:45:06.241024,0,5089,3.0,10,0.3
2025-08-18T11:45:06.741817,0,5089,3.0,10,0.1
2025-08-18T11:45:07.242476,0,5089,3.0,10,0.1
2025-08-18T11:45:07.743281,0,5089,3.0,10,0.1
2025-08-18T11:45:08.244066,0,5089,3.0,10,0.1
2025-08-18T11:45:08.744867,0,5089,3.0,10,0.1
2025-08-18T11:45:09.245505,0,5089,3.0,10,0.1
2025-08-18T11:45:09.746294,0,5089,3.0,10,0.1
2025-08-18T11:45:10.247019,0,5089,3.0,10,0.2
2025-08-18T11:45:10.747831,0,5089,3.0,10,0.2
2025-08-18T11:45:11.248367,0,5089,3.0,10,0.4
2025-08-18T11:45:11.749146,0,5089,3.0,10,0.2
2025-08-18T11:45:12.249577,0,5089,3.0,10,0.4
2025-08-18T11:45:12.750281,0,5089,3.0,10,0.3
2025-08-18T11:45:13.250939,0,5089,3.0,10,0.3
2025-08-18T11:45:13.751711,0,5089,3.0,10,0.4
2025-08-18T11:45:14.252377,0,5089,3.0,10,0.2
2025-08-18T11:45:14.753066,0,5089,3.0,10,0.2
2025-08-18T11:45:15.253821,0,5089,3.0,10,0.2
2025-08-18T11:45:15.754552,0,5089,3.0,10,0.1
2025-08-18T11:45:16.255287,0,5089,3.0,10,0.3
2025-08-18T11:45:16.756019,0,5089,3.0,10,0.1
2025-08-18T11:45:17.256805,0,5089,3.0,10,0.2
2025-08-18T11:45:17.757577,0,5089,3.0,10,0.1
2025-08-18T11:45:18.258181,0,5089,3.0,10,0.2
2025-08-18T11:45:18.758927,0,5089,3.0,10,0.2
2025-08-18T11:45:19.259548,0,5089,3.0,10,0.3
2025-08-18T11:45:19.760234,0,5089,3.0,10,0.1
2025-08-18T11:45:20.260918,0,5089,3.0,10,0.1
2025-08-18T11:45:20.761542,0,5089,3.0,10,0.2
2025-08-18T11:45:21.262171,0,5089,3.0,10,0.1
2025-08-18T11:45:21.762915,0,5089,3.0,10,0.2
2025-08-18T11:45:22.263696,0,5089,3.0,10,0.1
2025-08-18T11:45:22.764323,0,5089,3.0,10,0.1
2025-08-18T11:45:23.264902,0,5089,3.0,10,0.1
2025-08-18T11:45:23.765452,0,5089,3.0,10,0.2
2025-08-18T11:45:24.266135,0,5089,3.0,10,0.2
2025-08-18T11:45:24.766909,0,5089,3.0,10,0.1
2025-08-18T11:45:25.267641,0,5089,3.0,10,0.2
2025-08-18T11:45:25.768242,0,5089,3.0,10,0.1
2025-08-18T11:45:26.269005,0,5089,3.0,10,0.1
2025-08-18T11:45:26.769777,0,5089,3.0,10,0.1
2025-08-18T11:45:27.270481,0,5089,3.0,10,0.1
2025-08-18T11:45:27.771172,0,5089,3.0,10,0.1
2025-08-18T11:45:28.271934,0,5089,3.0,10,0.1
2025-08-18T11:45:28.772592,0,5089,3.0,10,0.2
2025-08-18T11:45:29.273288,0,5089,3.0,10,0.2
2025-08-18T11:45:29.773920,0,5089,3.0,10,0.1
2025-08-18T11:45:30.274701,0,5089,3.0,10,0.2
2025-08-18T11:45:30.775421,0,5089,3.0,10,0.1
2025-08-18T11:45:31.276125,0,5089,3.0,10,0.1
2025-08-18T11:45:31.776893,0,5089,3.0,10,0.1
2025-08-18T11:45:32.277633,0,5089,3.0,10,0.1
2025-08-18T11:45:32.778290,0,5089,3.0,10,0.2
2025-08-18T11:45:33.278974,0,5089,3.0,10,0.2
2025-08-18T11:45:33.779592,0,5089,3.0,10,0.1
2025-08-18T11:45:34.280182,0,5089,3.0,10,0.2
2025-08-18T11:45:34.780867,0,5089,3.0,10,0.2
2025-08-18T11:45:35.281475,0,5089,3.0,10,0.1
2025-08-18T11:45:35.782045,0,5089,3.0,10,0.1
2025-08-18T11:45:36.282697,0,5089,3.0,10,0.1
2025-08-18T11:45:36.783268,0,5089,3.0,10,0.2
2025-08-18T11:45:37.284004,0,5089,3.0,10,0.1
2025-08-18T11:45:37.784583,0,5089,3.0,10,0.1
2025-08-18T11:45:38.285201,0,5089,3.0,10,0.2
2025-08-18T11:45:38.785903,0,5089,3.0,10,0.2
2025-08-18T11:45:39.286606,0,5089,3.0,10,0.2
2025-08-18T11:45:39.787336,0,5089,3.0,10,0.2
2025-08-18T11:45:40.287944,0,5089,3.0,10,0.2
2025-08-18T11:45:40.788751,0,5089,3.0,10,0.0
2025-08-18T11:45:41.289420,0,5089,3.0,10,0.1
2025-08-18T11:45:41.790113,0,5089,3.0,10,0.4
2025-08-18T11:45:42.290897,0,5089,3.0,10,0.1
2025-08-18T11:45:42.791724,0,5089,3.0,10,0.8
2025-08-18T11:45:43.292560,0,5089,3.0,10,0.2
2025-08-18T11:45:43.793134,0,5089,3.0,10,0.4
2025-08-18T11:45:44.293866,0,5089,3.0,10,0.2
2025-08-18T11:45:44.794642,0,5089,3.0,10,0.3
2025-08-18T11:45:45.295410,0,5089,3.0,10,0.2
2025-08-18T11:45:45.796224,0,5089,3.0,10,0.1
2025-08-18T11:45:46.296946,0,5089,3.0,10,0.1
2025-08-18T11:45:46.797713,0,5089,3.0,10,0.2
2025-08-18T11:45:47.298476,0,5089,3.0,10,0.1
2025-08-18T11:45:47.799162,0,5089,3.0,10,0.2
2025-08-18T11:45:48.299870,0,5089,3.0,10,0.6
2025-08-18T11:45:48.800569,0,5089,3.0,10,0.3
2025-08-18T11:45:49.301225,0,5089,3.0,10,0.8
2025-08-18T11:45:49.801992,0,5089,3.0,10,0.4
2025-08-18T11:45:50.302781,0,5089,3.0,10,0.1
2025-08-18T11:45:50.803555,0,5089,3.0,10,0.1
2025-08-18T11:45:51.304242,0,5089,3.0,10,0.2
2025-08-18T11:45:51.804963,0,5089,3.0,10,0.1
2025-08-18T11:45:52.305585,0,5089,3.0,10,0.1
2025-08-18T11:45:52.806200,0,5089,3.0,10,0.4
2025-08-18T11:45:53.306908,0,5089,3.0,10,1.7
2025-08-18T11:45:53.807457,0,5089,3.0,10,0.2
2025-08-18T11:45:54.308042,0,5089,3.0,10,0.1
2025-08-18T11:45:54.808782,0,5089,3.0,10,0.1
2025-08-18T11:45:55.309389,0,5089,3.0,10,0.1
2025-08-18T11:45:55.810091,0,5089,3.0,10,0.1
2025-08-18T11:45:56.310780,0,5089,3.0,10,0.1
2025-08-18T11:45:56.811383,0,5089,3.0,10,0.2
2025-08-18T11:45:57.312041,0,5089,3.0,10,0.1
2025-08-18T11:45:57.812686,0,5089,3.0,10,0.0
2025-08-18T11:45:58.313267,0,5089,3.0,10,0.4
2025-08-18T11:45:58.813572,0,5089,3.0,10,0.6
2025-08-18T11:45:59.314285,0,5089,3.0,10,0.3
2025-08-18T11:45:59.815133,0,5089,3.0,10,0.2
2025-08-18T11:46:00.315953,0,5089,3.0,10,0.2
2025-08-18T11:46:00.816813,0,5089,3.0,10,0.1
2025-08-18T11:46:01.317664,0,5089,3.0,10,0.2
2025-08-18T11:46:01.818560,0,5089,3.0,10,0.2
2025-08-18T11:46:02.319348,0,5089,3.0,10,0.1
2025-08-18T11:46:02.820198,0,5089,3.0,10,0.2
2025-08-18T11:46:03.320904,0,5089,3.0,10,0.6
2025-08-18T11:46:03.821632,0,5089,3.0,10,0.1
2025-08-18T11:46:04.322331,0,5089,3.0,10,0.2
2025-08-18T11:46:04.823131,0,5089,3.0,10,0.2
2025-08-18T11:46:05.324033,0,5089,3.0,10,0.1
2025-08-18T11:46:05.824862,0,5089,3.0,10,0.1
2025-08-18T11:46:06.325708,0,5089,3.0,10,0.0
2025-08-18T11:46:06.826555,0,5089,3.0,10,0.1
2025-08-18T11:46:07.327290,0,5089,3.0,10,0.2
2025-08-18T11:46:07.828093,0,5089,3.0,10,0.1
2025-08-18T11:46:08.328946,0,5089,3.0,10,0.2
2025-08-18T11:46:08.829787,0,5089,3.0,10,0.1
2025-08-18T11:46:09.330601,0,5089,3.0,10,0.1
2025-08-18T11:46:09.831397,0,5089,3.0,10,0.2
2025-08-18T11:46:10.332170,0,5089,3.0,10,0.1
2025-08-18T11:46:10.832987,0,5089,3.0,10,0.2
2025-08-18T11:46:11.333854,0,5089,3.0,10,0.1
2025-08-18T11:46:11.834599,0,5089,3.0,10,0.5
2025-08-18T11:46:12.335371,0,5089,3.0,10,0.1
2025-08-18T11:46:12.836157,0,5089,3.0,10,0.8
2025-08-18T11:46:13.336960,0,5089,3.0,10,0.2
2025-08-18T11:46:13.837768,0,5089,3.0,10,0.4
2025-08-18T11:46:14.338583,0,5089,3.0,10,0.3
2025-08-18T11:46:14.839370,0,5089,3.0,10,0.2
2025-08-18T11:46:15.340132,0,5089,3.0,10,0.2
2025-08-18T11:46:15.841037,0,5089,3.0,10,0.2
2025-08-18T11:46:16.341879,0,5089,3.0,10,0.1
2025-08-18T11:46:16.842715,0,5089,3.0,10,0.1
2025-08-18T11:46:17.343397,0,5089,3.0,10,0.3
2025-08-18T11:46:17.844263,0,5089,3.0,10,0.1
2025-08-18T11:46:18.345015,0,5089,3.0,10,0.1
2025-08-18T11:46:18.845938,0,5089,3.0,10,0.2
2025-08-18T11:46:19.346726,0,5089,3.0,10,0.2
2025-08-18T11:46:19.847585,0,5089,3.0,10,0.1
2025-08-18T11:46:20.348271,0,5089,3.0,10,0.1
2025-08-18T11:46:20.849089,0,5089,3.0,10,0.1
2025-08-18T11:46:21.349954,0,5089,3.0,10,0.1
2025-08-18T11:46:21.850802,0,5089,3.0,10,0.1
2025-08-18T11:46:22.351589,0,5089,3.0,10,0.1
2025-08-18T11:46:22.852340,0,5089,3.0,10,0.1
2025-08-18T11:46:23.353135,0,5089,3.0,10,0.2
2025-08-18T11:46:23.853972,0,5089,3.0,10,0.1
2025-08-18T11:46:24.354709,0,5089,3.0,10,0.2
2025-08-18T11:46:24.855412,0,5089,3.0,10,0.1
2025-08-18T11:46:25.356155,0,5089,3.0,10,0.1
2025-08-18T11:46:25.856962,0,5089,3.0,10,0.2
2025-08-18T11:46:26.357754,0,5089,3.0,10,0.0
2025-08-18T11:46:26.858409,0,5089,3.0,10,0.2
2025-08-18T11:46:27.359102,0,5089,3.0,10,0.2
2025-08-18T11:46:27.859944,0,5089,3.0,10,0.1
2025-08-18T11:46:28.360698,0,5089,3.0,10,0.2
2025-08-18T11:46:28.861333,0,5089,3.0,10,0.1
2025-08-18T11:46:29.362097,0,5089,3.0,10,0.2
2025-08-18T11:46:29.862825,0,5089,3.0,10,0.1
2025-08-18T11:46:30.363543,0,5089,3.0,10,0.1
2025-08-18T11:46:30.864258,0,5089,3.0,10,0.2
2025-08-18T11:46:31.365038,0,5089,3.0,10,0.1
2025-08-18T11:46:31.865832,0,5089,3.0,10,0.1
2025-08-18T11:46:32.366464,0,5089,3.0,10,0.1
2025-08-18T11:46:32.867120,0,5089,3.0,10,0.2
2025-08-18T11:46:33.367931,0,5089,3.0,10,0.2
2025-08-18T11:46:33.868711,0,5089,3.0,10,0.1
2025-08-18T11:46:34.369573,0,5089,3.0,10,0.2
2025-08-18T11:46:34.870308,0,5089,3.0,10,0.2
2025-08-18T11:46:35.371074,0,5089,3.0,10,0.1
2025-08-18T11:46:35.871771,0,5089,3.0,10,0.1
2025-08-18T11:46:36.372446,0,5089,3.0,10,0.2
2025-08-18T11:46:36.873129,0,5089,3.0,10,0.1
2025-08-18T11:46:37.373915,0,5089,3.0,10,0.1
2025-08-18T11:46:37.874594,0,5089,3.0,10,0.1
2025-08-18T11:46:38.375269,0,5089,3.0,10,0.1
2025-08-18T11:46:38.876082,0,5089,3.0,10,0.1
2025-08-18T11:46:39.376871,0,5089,3.0,10,0.3
2025-08-18T11:46:39.877586,0,5089,3.0,10,0.1
2025-08-18T11:46:40.378360,0,5089,3.0,10,0.1
2025-08-18T11:46:40.879170,0,5089,3.0,10,0.2
2025-08-18T11:46:41.379959,0,5089,3.0,10,0.1
2025-08-18T11:46:41.880617,0,5089,3.0,10,0.4
2025-08-18T11:46:42.381262,0,5089,3.0,10,0.2
2025-08-18T11:46:42.882019,0,5089,3.0,10,0.8
2025-08-18T11:46:43.382798,0,5089,3.0,10,0.1
2025-08-18T11:46:43.883492,0,5089,3.0,10,0.4
2025-08-18T11:46:44.384164,0,5089,3.0,10,0.2
2025-08-18T11:46:44.884980,0,5089,3.0,10,0.1
2025-08-18T11:46:45.385658,0,5089,3.0,10,0.1
2025-08-18T11:46:45.886290,0,5089,3.0,10,0.2
2025-08-18T11:46:46.386967,0,5089,3.0,10,0.1
2025-08-18T11:46:46.888137,0,5089,3.0,10,0.2
2025-08-18T11:46:47.388885,0,5089,3.0,10,0.1
2025-08-18T11:46:47.889695,0,5089,3.0,10,0.1
2025-08-18T11:46:48.390584,0,5089,3.0,10,0.4
2025-08-18T11:46:48.891364,0,5089,3.0,10,0.2
2025-08-18T11:46:49.392150,0,5089,3.0,10,0.4
2025-08-18T11:46:49.892989,0,5089,3.0,10,0.1
2025-08-18T11:46:50.393884,0,5089,3.0,10,0.1
2025-08-18T11:46:50.894797,0,5089,3.0,10,0.1
2025-08-18T11:46:51.395681,0,5089,3.0,10,0.2
2025-08-18T11:46:51.896547,0,5089,3.0,10,0.1
2025-08-18T11:46:52.397257,0,5089,3.0,10,0.2
2025-08-18T11:46:52.898076,0,5089,3.0,10,0.1
2025-08-18T11:46:53.398863,0,5089,3.0,10,0.2
2025-08-18T11:46:53.899684,0,5089,3.0,10,0.1
2025-08-18T11:46:54.400409,0,5089,3.0,10,0.2
2025-08-18T11:46:54.901293,0,5089,3.0,10,0.1
2025-08-18T11:46:55.402098,0,5089,3.0,10,0.2
2025-08-18T11:46:55.902879,0,5089,3.0,10,0.1
2025-08-18T11:46:56.403682,0,5089,3.0,10,0.1
2025-08-18T11:46:56.904372,0,5089,3.0,10,0.2
2025-08-18T11:46:57.405187,0,5089,3.0,10,0.1
2025-08-18T11:46:57.905954,0,5089,3.0,10,0.2
2025-08-18T11:46:58.406746,0,5089,3.0,10,0.2
2025-08-18T11:46:58.907084,0,5089,3.0,10,0.7
2025-08-18T11:46:59.407811,0,5089,3.0,10,0.2
2025-08-18T11:46:59.908606,0,5089,3.0,10,0.1
2025-08-18T11:47:00.409394,0,5089,3.0,10,0.2
2025-08-18T11:47:00.909824,0,5089,3.0,10,1.7
2025-08-18T11:47:01.410582,0,5089,3.0,10,0.1
2025-08-18T11:47:01.911315,0,5089,3.0,10,0.1
2025-08-18T11:47:02.412067,0,5089,3.0,10,0.1
2025-08-18T11:47:02.912857,0,5089,3.0,10,1.9
2025-08-18T11:47:03.413861,0,5089,3.0,10,0.4
2025-08-18T11:47:03.914801,0,5089,3.0,10,0.1
2025-08-18T11:47:04.415626,0,5089,3.0,10,0.2
2025-08-18T11:47:04.916457,0,5089,3.0,10,0.2
2025-08-18T11:47:05.417186,0,5089,3.0,10,0.2
2025-08-18T11:47:05.918017,0,5089,3.0,10,0.2
2025-08-18T11:47:06.418880,0,5089,3.0,10,0.1
2025-08-18T11:47:06.919701,0,5089,3.0,10,0.1
2025-08-18T11:47:07.420487,0,5089,3.0,10,0.1
2025-08-18T11:47:07.921280,0,5089,3.0,10,0.1
2025-08-18T11:47:08.422068,0,5089,3.0,10,0.2
2025-08-18T11:47:08.922865,0,5089,3.0,10,0.1
2025-08-18T11:47:09.423717,0,5089,3.0,10,0.2
2025-08-18T11:47:09.924550,0,5089,3.0,10,0.1
2025-08-18T11:47:10.425331,0,5089,3.0,10,0.2
2025-08-18T11:47:10.926093,0,5089,3.0,10,0.2
2025-08-18T11:47:11.426904,0,5089,3.0,10,0.1
2025-08-18T11:47:11.927686,0,5089,3.0,10,0.6
2025-08-18T11:47:12.428498,0,5089,3.0,10,0.2
2025-08-18T11:47:12.929282,0,5089,3.0,10,0.8
2025-08-18T11:47:13.430087,0,5089,3.0,10,0.2
2025-08-18T11:47:13.930896,0,5089,3.0,10,0.4
2025-08-18T11:47:14.431589,0,5089,3.0,10,0.2
2025-08-18T11:47:14.932354,0,5089,3.0,10,0.3
2025-08-18T11:47:15.433142,0,5089,3.0,10,0.2
2025-08-18T11:47:15.933984,0,5089,3.0,10,0.2
2025-08-18T11:47:16.434835,0,5089,3.0,10,0.2
2025-08-18T11:47:16.935684,0,5089,3.0,10,0.2
2025-08-18T11:47:17.436492,0,5089,3.0,10,0.1
2025-08-18T11:47:17.937397,0,5089,3.0,10,0.2
2025-08-18T11:47:18.438167,0,5089,3.0,10,0.1
2025-08-18T11:47:18.939018,0,5089,3.0,10,0.2
2025-08-18T11:47:19.439852,0,5089,3.0,10,0.2
2025-08-18T11:47:19.940794,0,5089,3.0,10,0.2
2025-08-18T11:47:20.441681,0,5089,3.0,10,0.1
2025-08-18T11:47:20.942603,0,5089,3.0,10,0.2
2025-08-18T11:47:21.443455,0,5089,3.0,10,0.1
2025-08-18T11:47:21.944308,0,5089,3.0,10,0.1
2025-08-18T11:47:22.445064,0,5089,3.0,10,0.1
2025-08-18T11:47:22.945926,0,5089,3.0,10,0.2
2025-08-18T11:47:23.446806,0,5089,3.0,10,0.2
2025-08-18T11:47:23.947637,0,5089,3.0,10,0.2
2025-08-18T11:47:24.448452,0,5089,3.0,10,0.2
2025-08-18T11:47:24.949154,0,5089,3.0,10,0.2
2025-08-18T11:47:25.449966,0,5089,3.0,10,0.1
2025-08-18T11:47:25.950818,0,5089,3.0,10,0.1
2025-08-18T11:47:26.451666,0,5089,3.0,10,0.1
2025-08-18T11:47:26.952491,0,5089,3.0,10,0.2
2025-08-18T11:47:27.453283,0,5089,3.0,10,0.2
2025-08-18T11:47:27.954094,0,5089,3.0,10,0.1
2025-08-18T11:47:28.454952,0,5089,3.0,10,0.2
2025-08-18T11:47:28.955770,0,5089,3.0,10,0.1
2025-08-18T11:47:29.456437,0,5089,3.0,10,0.1
2025-08-18T11:47:29.957268,0,5089,3.0,10,0.2
2025-08-18T11:47:30.458116,0,5089,3.0,10,0.1
2025-08-18T11:47:30.958976,0,5089,3.0,10,0.2
2025-08-18T11:47:31.459893,0,5089,3.0,10,0.1
2025-08-18T11:47:31.960750,0,5089,3.0,10,0.1
2025-08-18T11:47:32.461588,0,5089,3.0,10,0.2
2025-08-18T11:47:32.962442,0,5089,3.0,10,0.1
2025-08-18T11:47:33.463318,0,5089,3.0,10,0.2
2025-08-18T11:47:33.964143,0,5089,3.0,10,0.1
2025-08-18T11:47:34.465011,0,5089,3.0,10,0.2
2025-08-18T11:47:34.965873,0,5089,3.0,10,0.2
2025-08-18T11:47:35.466742,0,5089,3.0,10,0.1
2025-08-18T11:47:35.967576,0,5089,3.0,10,0.1
2025-08-18T11:47:36.468363,0,5089,3.0,10,0.1
2025-08-18T11:47:36.969095,0,5089,3.0,10,0.1
2025-08-18T11:47:37.469914,0,5089,3.0,10,0.1
2025-08-18T11:47:37.970816,0,5089,3.0,10,0.2
2025-08-18T11:47:38.471648,0,5089,3.0,10,0.1
2025-08-18T11:47:38.972423,0,5089,3.0,10,0.1
2025-08-18T11:47:39.473226,0,5089,3.0,10,0.3
2025-08-18T11:47:39.974105,0,5089,3.0,10,0.1
2025-08-18T11:47:40.474990,0,5089,3.0,10,0.2
2025-08-18T11:47:40.975790,0,5089,3.0,10,0.1
2025-08-18T11:47:41.476634,0,5089,3.0,10,0.2
2025-08-18T11:47:41.977332,0,5089,3.0,10,0.3
2025-08-18T11:47:42.478163,0,5089,3.0,10,0.2
2025-08-18T11:47:42.978807,0,5089,3.0,10,0.8
2025-08-18T11:47:43.479676,0,5089,3.0,10,0.1
2025-08-18T11:47:43.980312,0,5089,3.0,10,0.4
2025-08-18T11:47:44.481113,0,5089,3.0,10,0.2
2025-08-18T11:47:44.981944,0,5089,3.0,10,0.3
2025-08-18T11:47:45.482772,0,5089,3.0,10,0.1
2025-08-18T11:47:45.983499,0,5089,3.0,10,0.2
2025-08-18T11:47:46.484322,0,5089,3.0,10,0.1
2025-08-18T11:47:46.985059,0,5089,3.0,10,0.2
2025-08-18T11:47:47.485829,0,5089,3.0,10,0.1
2025-08-18T11:47:47.986552,0,5089,3.0,10,0.1
2025-08-18T11:47:48.487266,0,5089,3.0,10,0.4
2025-08-18T11:47:48.987974,0,5089,3.0,10,0.3
2025-08-18T11:47:49.488760,0,5089,3.0,10,0.2
2025-08-18T11:47:49.989552,0,5089,3.0,10,0.1
2025-08-18T11:47:50.490265,0,5089,3.0,10,0.2
2025-08-18T11:47:50.990948,0,5089,3.0,10,0.2
2025-08-18T11:47:51.491691,0,5089,3.0,10,0.1
2025-08-18T11:47:51.992434,0,5089,3.0,10,0.1
2025-08-18T11:47:52.493185,0,5089,3.0,10,0.1
2025-08-18T11:47:52.993920,0,5089,3.0,10,0.1
2025-08-18T11:47:53.494674,0,5089,3.0,10,0.1
2025-08-18T11:47:53.995414,0,5089,3.0,10,0.1
2025-08-18T11:47:54.496110,0,5089,3.0,10,0.2
2025-08-18T11:47:54.996888,0,5089,3.0,10,0.1
2025-08-18T11:47:55.497688,0,5089,3.0,10,0.1
2025-08-18T11:47:55.998429,0,5089,3.0,10,0.1
2025-08-18T11:47:56.499264,0,5089,3.0,10,0.2
2025-08-18T11:47:57.000010,0,5089,3.0,10,0.2
2025-08-18T11:47:57.500689,0,5089,3.0,10,0.1
2025-08-18T11:47:58.001366,0,5089,3.0,10,0.4
2025-08-18T11:47:58.502035,0,5089,3.0,10,0.1
2025-08-18T11:47:59.002809,0,5089,3.0,10,0.7
2025-08-18T11:47:59.503560,0,5089,3.0,10,0.2
2025-08-18T11:48:00.004205,0,5089,3.0,10,0.2
2025-08-18T11:48:00.504950,0,5089,3.0,10,0.1
2025-08-18T11:48:01.005728,0,5089,3.0,10,0.1
2025-08-18T11:48:01.506335,0,5089,3.0,10,0.1
2025-08-18T11:48:02.007041,0,5089,3.0,10,0.2
2025-08-18T11:48:02.507841,0,5089,3.0,10,0.1
2025-08-18T11:48:03.008462,0,5089,3.0,10,0.2
2025-08-18T11:48:03.509226,0,5089,3.0,10,0.5
2025-08-18T11:48:04.009980,0,5089,3.0,10,0.2
2025-08-18T11:48:04.510739,0,5089,3.0,10,0.2
2025-08-18T11:48:05.011451,0,5089,3.0,10,0.1
2025-08-18T11:48:05.512154,0,5089,3.0,10,0.1
2025-08-18T11:48:06.012942,0,5089,3.0,10,0.1
2025-08-18T11:48:06.513616,0,5089,3.0,10,0.1
2025-08-18T11:48:07.014269,0,5089,3.0,10,0.2
2025-08-18T11:48:07.514952,0,5089,3.0,10,0.1
2025-08-18T11:48:08.015616,0,5089,3.0,10,0.1
2025-08-18T11:48:08.516300,0,5089,3.0,10,0.2
2025-08-18T11:48:09.017007,0,5089,3.0,10,0.2
2025-08-18T11:48:09.517748,0,5089,3.0,10,0.1
2025-08-18T11:48:10.018478,0,5089,3.0,10,0.1
2025-08-18T11:48:10.519277,0,5089,3.0,10,0.1
2025-08-18T11:48:11.019960,0,5089,3.0,10,2.0
2025-08-18T11:48:11.520741,0,5089,3.0,10,0.1
2025-08-18T11:48:12.021217,0,5089,3.0,10,0.2
2025-08-18T11:48:12.521942,0,5089,3.0,10,0.4
2025-08-18T11:48:13.022666,0,5089,3.0,10,0.1
2025-08-18T11:48:13.523405,0,5089,3.0,10,0.8
2025-08-18T11:48:14.024165,0,5089,3.0,10,0.1
2025-08-18T11:48:14.524948,0,5089,3.0,10,0.4
2025-08-18T11:48:15.025747,0,5089,3.0,10,0.1
2025-08-18T11:48:15.526533,0,5089,3.0,10,0.3
2025-08-18T11:48:16.026833,0,5089,3.0,10,0.1
2025-08-18T11:48:16.527504,0,5089,3.0,10,0.3
2025-08-18T11:48:17.028220,0,5089,3.0,10,0.1
2025-08-18T11:48:17.528945,0,5089,3.0,10,0.1
2025-08-18T11:48:18.029717,0,5089,3.0,10,0.2
2025-08-18T11:48:18.530440,0,5089,3.0,10,0.2
2025-08-18T11:48:19.031242,0,5089,3.0,10,0.2
2025-08-18T11:48:19.532040,0,5089,3.0,10,0.3
2025-08-18T11:48:20.032862,0,5089,3.0,10,0.2
2025-08-18T11:48:20.533641,0,5089,3.0,10,0.2
2025-08-18T11:48:21.034381,0,5089,3.0,10,0.2
2025-08-18T11:48:21.535132,0,5089,3.0,10,0.1
2025-08-18T11:48:22.035938,0,5089,3.0,10,0.2
2025-08-18T11:48:22.536689,0,5089,3.0,10,0.1
2025-08-18T11:48:23.037438,0,5089,3.0,10,0.1
2025-08-18T11:48:23.538250,0,5089,3.0,10,0.1
2025-08-18T11:48:24.038976,0,5089,3.0,10,0.2
2025-08-18T11:48:24.539725,0,5089,3.0,10,0.2
2025-08-18T11:48:25.040444,0,5089,3.0,10,0.1
2025-08-18T11:48:25.541188,0,5089,3.0,10,0.2
2025-08-18T11:48:26.041914,0,5089,3.0,10,0.1
2025-08-18T11:48:26.542677,0,5089,3.0,10,0.1
2025-08-18T11:48:27.043352,0,5089,3.0,10,0.1
2025-08-18T11:48:27.544078,0,5089,3.0,10,0.2
2025-08-18T11:48:28.044790,0,5089,3.0,10,0.1
2025-08-18T11:48:28.545558,0,5089,3.0,10,0.2
2025-08-18T11:48:29.046220,0,5089,3.0,10,0.1
2025-08-18T11:48:29.546947,0,5089,3.0,10,0.2
2025-08-18T11:48:30.047678,0,5089,3.0,10,0.1
2025-08-18T11:48:30.548454,0,5089,3.0,10,0.1
2025-08-18T11:48:31.049170,0,5089,3.0,10,0.2
2025-08-18T11:48:31.549855,0,5089,3.0,10,0.1
2025-08-18T11:48:32.050591,0,5089,3.0,10,0.1
2025-08-18T11:48:32.551246,0,5089,3.0,10,0.3
2025-08-18T11:48:33.051906,0,5089,3.0,10,0.2
2025-08-18T11:48:33.552624,0,5089,3.0,10,0.2
2025-08-18T11:48:34.053344,0,5089,3.0,10,0.1
2025-08-18T11:48:34.554079,0,5089,3.0,10,0.2
2025-08-18T11:48:35.054844,0,5089,3.0,10,0.1
2025-08-18T11:48:35.555412,0,5089,3.0,10,0.2
2025-08-18T11:48:36.056068,0,5089,3.0,10,0.2
2025-08-18T11:48:36.556763,0,5089,3.0,10,0.1
2025-08-18T11:48:37.057343,0,5089,3.0,10,0.1
2025-08-18T11:48:37.558054,0,5089,3.0,10,0.2
2025-08-18T11:48:38.058779,0,5089,3.0,10,0.1
2025-08-18T11:48:38.559383,0,5089,3.0,10,0.2
2025-08-18T11:48:39.060052,0,5089,3.0,10,0.0
2025-08-18T11:48:39.560792,0,5089,3.0,10,0.3
2025-08-18T11:48:40.061386,0,5089,3.0,10,0.2
2025-08-18T11:48:40.562068,0,5089,3.0,10,0.1
2025-08-18T11:48:41.062798,0,5089,3.0,10,0.1
2025-08-18T11:48:41.563493,0,5089,3.0,10,0.2
2025-08-18T11:48:42.064126,0,5089,3.0,10,0.1
2025-08-18T11:48:42.564922,0,5089,3.0,10,0.4
2025-08-18T11:48:43.065665,0,5089,3.0,10,0.2
2025-08-18T11:48:43.566390,0,5089,3.0,10,0.7
2025-08-18T11:48:44.067057,0,5089,3.0,10,0.1
2025-08-18T11:48:44.567763,0,5089,3.0,10,0.4
2025-08-18T11:48:45.068449,0,5089,3.0,10,0.1
2025-08-18T11:48:45.569338,0,5089,3.0,10,0.1
2025-08-18T11:48:46.070142,0,5089,3.0,10,0.2
2025-08-18T11:48:46.570887,0,5089,3.0,10,0.2
2025-08-18T11:48:47.071700,0,5089,3.0,10,0.2
2025-08-18T11:48:47.572444,0,5089,3.0,10,0.2
2025-08-18T11:48:48.073255,0,5089,3.0,10,0.1
2025-08-18T11:48:48.573910,0,5089,3.0,10,0.5
2025-08-18T11:48:49.074475,0,5089,3.0,10,0.4
2025-08-18T11:48:49.575155,0,5089,3.0,10,0.2
2025-08-18T11:48:50.075902,0,5089,3.0,10,0.2
2025-08-18T11:48:50.576662,0,5089,3.0,10,0.1
2025-08-18T11:48:51.077466,0,5089,3.0,10,0.1
2025-08-18T11:48:51.578139,0,5089,3.0,10,0.1
2025-08-18T11:48:52.078861,0,5089,3.0,10,0.2
2025-08-18T11:48:52.579595,0,5089,3.0,10,0.0
2025-08-18T11:48:53.080273,0,5089,3.0,10,0.2
2025-08-18T11:48:53.580956,0,5089,3.0,10,0.1
2025-08-18T11:48:54.081799,0,5089,3.0,10,0.4
2025-08-18T11:48:54.582551,0,5089,3.0,10,0.2
2025-08-18T11:48:55.083261,0,5089,3.0,10,0.2
2025-08-18T11:48:55.583963,0,5089,3.0,10,0.1
2025-08-18T11:48:56.084673,0,5089,3.0,10,0.1
2025-08-18T11:48:56.585317,0,5089,3.0,10,0.1
2025-08-18T11:48:57.086040,0,5089,3.0,10,0.1
2025-08-18T11:48:57.586766,0,5089,3.0,10,0.2
2025-08-18T11:48:58.087492,0,5089,3.0,10,0.1
2025-08-18T11:48:58.588198,0,5089,3.0,10,0.2
2025-08-18T11:48:59.088881,0,5089,3.0,10,0.7
2025-08-18T11:48:59.589601,0,5089,3.0,10,0.3
2025-08-18T11:49:00.090333,0,5089,3.0,10,0.1
2025-08-18T11:49:00.591038,0,5089,3.0,10,0.2
2025-08-18T11:49:01.091788,0,5089,3.0,10,0.2
2025-08-18T11:49:01.592593,0,5089,3.0,10,0.2
2025-08-18T11:49:02.093193,0,5089,3.0,10,0.1
2025-08-18T11:49:02.593922,0,5089,3.0,10,0.2
2025-08-18T11:49:03.094601,0,5089,3.0,10,0.2
2025-08-18T11:49:03.595315,0,5089,3.0,10,0.1
2025-08-18T11:49:04.096045,0,5089,3.0,10,0.1
2025-08-18T11:49:04.596839,0,5089,3.0,10,0.2
2025-08-18T11:49:05.097455,0,5089,3.0,10,0.2
2025-08-18T11:49:05.598166,0,5089,3.0,10,0.2
2025-08-18T11:49:06.098977,0,5089,3.0,10,0.1
2025-08-18T11:49:06.599668,0,5089,3.0,10,0.1
2025-08-18T11:49:07.100360,0,5089,3.0,10,0.1
2025-08-18T11:49:07.601052,0,5089,3.0,10,0.2
2025-08-18T11:49:08.101739,0,5089,3.0,10,0.1
2025-08-18T11:49:08.602323,0,5089,3.0,10,0.2
2025-08-18T11:49:09.103091,0,5089,3.0,10,0.2
2025-08-18T11:49:09.603866,0,5089,3.0,10,0.1
2025-08-18T11:49:10.104616,0,5089,3.0,10,0.1
2025-08-18T11:49:10.605313,0,5089,3.0,10,0.2
2025-08-18T11:49:11.106095,0,5089,3.0,10,0.2
2025-08-18T11:49:11.606826,0,5089,3.0,10,0.1
2025-08-18T11:49:12.107602,0,5089,3.0,10,0.2
2025-08-18T11:49:12.608365,0,5089,3.0,10,0.5
2025-08-18T11:49:13.109058,0,5089,3.0,10,0.2
2025-08-18T11:49:13.609880,0,5089,3.0,10,0.8
2025-08-18T11:49:14.110654,0,5089,3.0,10,0.1
2025-08-18T11:49:14.611251,0,5089,3.0,10,0.3
2025-08-18T11:49:15.111978,0,5089,3.0,10,0.1
2025-08-18T11:49:15.612735,0,5089,3.0,10,0.2
2025-08-18T11:49:16.113344,0,5089,3.0,10,0.2
2025-08-18T11:49:16.614112,0,5089,3.0,10,0.2
2025-08-18T11:49:17.114861,0,5089,3.0,10,0.1
2025-08-18T11:49:17.615621,0,5089,3.0,10,0.1
2025-08-18T11:49:18.116368,0,5089,3.0,10,0.2
2025-08-18T11:49:18.617084,0,5089,3.0,10,0.2
2025-08-18T11:49:19.117831,0,5089,3.0,10,0.1
2025-08-18T11:49:19.618569,0,5089,3.0,10,0.4
2025-08-18T11:49:20.119301,0,5089,3.0,10,0.0
2025-08-18T11:49:20.620024,0,5089,3.0,10,1.9
2025-08-18T11:49:21.120812,0,5089,3.0,10,0.1
2025-08-18T11:49:21.621383,0,5089,3.0,10,0.2
2025-08-18T11:49:22.122102,0,5089,3.0,10,0.1
2025-08-18T11:49:22.622720,0,5089,3.0,10,0.2
2025-08-18T11:49:23.123407,0,5089,3.0,10,0.1
2025-08-18T11:49:23.624083,0,5089,3.0,10,0.1
2025-08-18T11:49:24.124914,0,5089,3.0,10,0.1
2025-08-18T11:49:24.625555,0,5089,3.0,10,0.2
2025-08-18T11:49:25.126232,0,5089,3.0,10,0.1
2025-08-18T11:49:25.626996,0,5089,3.0,10,0.1
2025-08-18T11:49:26.127787,0,5089,3.0,10,0.2
2025-08-18T11:49:26.628502,0,5089,3.0,10,0.2
2025-08-18T11:49:27.129218,0,5089,3.0,10,0.2
2025-08-18T11:49:27.629960,0,5089,3.0,10,0.1
2025-08-18T11:49:28.130762,0,5089,3.0,10,0.1
2025-08-18T11:49:28.631449,0,5089,3.0,10,0.1
2025-08-18T11:49:29.132218,0,5089,3.0,10,0.2
2025-08-18T11:49:29.632982,0,5089,3.0,10,0.2
2025-08-18T11:49:30.133770,0,5089,3.0,10,0.2
2025-08-18T11:49:30.634555,0,5089,3.0,10,0.1
2025-08-18T11:49:31.135275,0,5089,3.0,10,0.1
2025-08-18T11:49:31.636047,0,5089,3.0,10,0.1
2025-08-18T11:49:32.136843,0,5089,3.0,10,0.2
2025-08-18T11:49:32.637559,0,5089,3.0,10,0.1
2025-08-18T11:49:33.138325,0,5089,3.0,10,0.1
2025-08-18T11:49:33.639060,0,5089,3.0,10,0.1
2025-08-18T11:49:34.139796,0,5089,3.0,10,0.1
2025-08-18T11:49:34.640593,0,5089,3.0,10,0.1
2025-08-18T11:49:35.141262,0,5089,3.0,10,0.1
2025-08-18T11:49:35.642002,0,5089,3.0,10,0.1
2025-08-18T11:49:36.142722,0,5089,3.0,10,0.1
2025-08-18T11:49:36.643447,0,5089,3.0,10,0.1
2025-08-18T11:49:37.144199,0,5089,3.0,10,0.2
2025-08-18T11:49:37.645012,0,5089,3.0,10,0.1
2025-08-18T11:49:38.145799,0,5089,3.0,10,0.2
2025-08-18T11:49:38.646457,0,5089,3.0,10,0.1
2025-08-18T11:49:39.147041,0,5089,3.0,10,0.1
2025-08-18T11:49:39.647834,0,5089,3.0,10,0.2
2025-08-18T11:49:40.148431,0,5089,3.0,10,0.2
2025-08-18T11:49:40.649124,0,5089,3.0,10,0.1
2025-08-18T11:49:41.149905,0,5089,3.0,10,0.1
2025-08-18T11:49:41.650691,0,5089,3.0,10,0.1
2025-08-18T11:49:42.151446,0,5089,3.0,10,0.1
2025-08-18T11:49:42.652039,0,5089,3.0,10,0.5
2025-08-18T11:49:43.152743,0,5089,3.0,10,0.2
2025-08-18T11:49:43.653422,0,5089,3.0,10,0.7
2025-08-18T11:49:44.154109,0,5089,3.0,10,0.1
2025-08-18T11:49:44.654802,0,5089,3.0,10,0.3
2025-08-18T11:49:45.155545,0,5089,3.0,10,0.2
2025-08-18T11:49:45.656349,0,5089,3.0,10,0.3
2025-08-18T11:49:46.157084,0,5089,3.0,10,0.1
2025-08-18T11:49:46.657878,0,5089,3.0,10,0.2
2025-08-18T11:49:47.158615,0,5089,3.0,10,0.2
2025-08-18T11:49:47.659401,0,5089,3.0,10,0.2
2025-08-18T11:49:48.159928,0,5089,3.0,10,0.5
2025-08-18T11:49:48.660710,0,5089,3.0,10,0.3
2025-08-18T11:49:49.161382,0,5089,3.0,10,0.4
2025-08-18T11:49:49.662198,0,5089,3.0,10,0.2
2025-08-18T11:49:50.163004,0,5089,3.0,10,0.2
2025-08-18T11:49:50.663819,0,5089,3.0,10,0.2
2025-08-18T11:49:51.164419,0,5089,3.0,10,0.1
2025-08-18T11:49:51.665162,0,5089,3.0,10,0.2
2025-08-18T11:49:52.165913,0,5089,3.0,10,0.2
2025-08-18T11:49:52.666628,0,5089,3.0,10,0.2
2025-08-18T11:49:53.167318,0,5089,3.0,10,0.1
2025-08-18T11:49:53.668053,0,5089,3.0,10,0.1
2025-08-18T11:49:54.168726,0,5089,3.0,10,0.1
2025-08-18T11:49:54.669406,0,5089,3.0,10,0.2
2025-08-18T11:49:55.170052,0,5089,3.0,10,0.1
2025-08-18T11:49:55.670836,0,5089,3.0,10,0.1
2025-08-18T11:49:56.171558,0,5089,3.0,10,0.1
2025-08-18T11:49:56.672279,0,5089,3.0,10,0.1
2025-08-18T11:49:57.172975,0,5089,3.0,10,0.2
2025-08-18T11:49:57.673702,0,5089,3.0,10,0.1
2025-08-18T11:49:58.174281,0,5089,3.0,10,0.2
2025-08-18T11:49:58.674950,0,5089,3.0,10,0.1
2025-08-18T11:49:59.175631,0,5089,3.0,10,0.8
2025-08-18T11:49:59.676297,0,5089,3.0,10,0.3
2025-08-18T11:50:00.176992,0,5089,3.0,10,0.1
2025-08-18T11:50:00.677776,0,5089,3.0,10,0.1
2025-08-18T11:50:01.178486,0,5089,3.0,10,0.2
2025-08-18T11:50:01.679163,0,5089,3.0,10,0.1
2025-08-18T11:50:02.179895,0,5089,3.0,10,0.1
2025-08-18T11:50:02.680640,0,5089,3.0,10,0.1
2025-08-18T11:50:03.181299,0,5089,3.0,10,0.7
2025-08-18T11:50:03.681936,0,5089,3.0,10,0.2
2025-08-18T11:50:04.182611,0,5089,3.0,10,0.1
2025-08-18T11:50:04.683270,0,5089,3.0,10,0.3
2025-08-18T11:50:05.183969,0,5089,3.0,10,0.1
2025-08-18T11:50:05.684667,0,5089,3.0,10,0.1
2025-08-18T11:50:06.185369,0,5089,3.0,10,0.1
2025-08-18T11:50:06.686023,0,5089,3.0,10,0.4
2025-08-18T11:50:07.186753,0,5089,3.0,10,0.1
2025-08-18T11:50:07.687323,0,5089,3.0,10,0.1
2025-08-18T11:50:08.188026,0,5089,3.0,10,0.2
2025-08-18T11:50:08.688777,0,5089,3.0,10,0.1
2025-08-18T11:50:09.189330,0,5089,3.0,10,0.1
2025-08-18T11:50:09.690018,0,5089,3.0,10,0.2
2025-08-18T11:50:10.190641,0,5089,3.0,10,0.1
2025-08-18T11:50:10.691198,0,5089,3.0,10,0.1
2025-08-18T11:50:11.191866,0,5089,3.0,10,0.1
2025-08-18T11:50:11.692445,0,5089,3.0,10,0.1
2025-08-18T11:50:12.193038,0,5089,3.0,10,0.1
2025-08-18T11:50:12.693582,0,5089,3.0,10,0.4
2025-08-18T11:50:13.194148,0,5089,3.0,10,0.2
2025-08-18T11:50:13.694898,0,5089,3.0,10,0.6
2025-08-18T11:50:14.195542,0,5089,3.0,10,0.1
2025-08-18T11:50:14.696214,0,5089,3.0,10,0.4
2025-08-18T11:50:15.196940,0,5089,3.0,10,0.1
2025-08-18T11:50:15.697714,0,5089,3.0,10,0.3
2025-08-18T11:50:16.198449,0,5089,3.0,10,0.4
2025-08-18T11:50:16.699220,0,5089,3.0,10,0.2
2025-08-18T11:50:17.200018,0,5089,3.0,10,0.1
2025-08-18T11:50:17.700812,0,5089,3.0,10,0.1
2025-08-18T11:50:18.201594,0,5089,3.0,10,0.3
2025-08-18T11:50:18.702316,0,5089,3.0,10,0.2
2025-08-18T11:50:19.203093,0,5089,3.0,10,0.1
2025-08-18T11:50:19.703959,0,5089,3.0,10,0.3
2025-08-18T11:50:20.204794,0,5089,3.0,10,0.1
2025-08-18T11:50:20.705639,0,5089,3.0,10,0.1
2025-08-18T11:50:21.206396,0,5089,3.0,10,0.1
2025-08-18T11:50:21.707233,0,5089,3.0,10,0.1
2025-08-18T11:50:22.208020,0,5089,3.0,10,0.1
2025-08-18T11:50:22.708838,0,5089,3.0,10,0.1
2025-08-18T11:50:23.209661,0,5089,3.0,10,0.1
2025-08-18T11:50:23.710433,0,5089,3.0,10,0.1
2025-08-18T11:50:24.211206,0,5089,3.0,10,0.2
2025-08-18T11:50:24.712030,0,5089,3.0,10,0.2
2025-08-18T11:50:25.212852,0,5089,3.0,10,0.1
2025-08-18T11:50:25.713640,0,5089,3.0,10,0.2
2025-08-18T11:50:26.214404,0,5089,3.0,10,0.1
2025-08-18T11:50:26.715174,0,5089,3.0,10,0.1
2025-08-18T11:50:27.215902,0,5089,3.0,10,0.1
2025-08-18T11:50:27.716628,0,5089,3.0,10,0.1
2025-08-18T11:50:28.217315,0,5089,3.0,10,0.2
2025-08-18T11:50:28.718045,0,5089,3.0,10,0.2
2025-08-18T11:50:29.218794,0,5089,3.0,10,0.1
2025-08-18T11:50:29.719500,0,5089,3.0,10,0.1
2025-08-18T11:50:30.220214,0,5089,3.0,10,0.1
2025-08-18T11:50:30.720995,0,5089,3.0,10,0.1
2025-08-18T11:50:31.221717,0,5089,3.0,10,0.1
2025-08-18T11:50:31.722424,0,5089,3.0,10,0.2
2025-08-18T11:50:32.223154,0,5089,3.0,10,1.4
2025-08-18T11:50:32.723889,0,5089,3.0,10,0.2
2025-08-18T11:50:33.224614,0,5089,3.0,10,0.1
2025-08-18T11:50:33.725402,0,5089,3.0,10,0.1
2025-08-18T11:50:34.226158,0,5089,3.0,10,0.2
2025-08-18T11:50:34.726897,0,5089,3.0,10,0.2
2025-08-18T11:50:35.227570,0,5089,3.0,10,0.1
2025-08-18T11:50:35.728343,0,5089,3.0,10,0.1
2025-08-18T11:50:36.229037,0,5089,3.0,10,0.1
2025-08-18T11:50:36.729788,0,5089,3.0,10,0.2
2025-08-18T11:50:37.230577,0,5089,3.0,10,0.1
2025-08-18T11:50:37.731288,0,5089,3.0,10,0.1
2025-08-18T11:50:38.231994,0,5089,3.0,10,0.1
2025-08-18T11:50:38.732739,0,5089,3.0,10,0.2
2025-08-18T11:50:39.233568,0,5089,3.0,10,0.1
2025-08-18T11:50:39.734312,0,5089,3.0,10,0.3
2025-08-18T11:50:40.235013,0,5089,3.0,10,0.2
2025-08-18T11:50:40.735564,0,5089,3.0,10,0.0
2025-08-18T11:50:41.236301,0,5089,3.0,10,0.2
2025-08-18T11:50:41.737111,0,5089,3.0,10,0.1
2025-08-18T11:50:42.237910,0,5089,3.0,10,0.1
2025-08-18T11:50:42.738446,0,5089,3.0,10,0.5
2025-08-18T11:50:43.239230,0,5089,3.0,10,0.2
2025-08-18T11:50:43.739527,0,5089,3.0,10,0.5
2025-08-18T11:50:44.240247,0,5089,3.0,10,0.3
2025-08-18T11:50:44.740955,0,5089,3.0,10,0.6
2025-08-18T11:50:45.241713,0,5089,3.0,10,0.3
2025-08-18T11:50:45.742316,0,5089,3.0,10,0.2
2025-08-18T11:50:46.243039,0,5089,3.0,10,0.2
2025-08-18T11:50:46.743663,0,5089,3.0,10,0.3
2025-08-18T11:50:47.244401,0,5089,3.0,10,0.1
2025-08-18T11:50:47.745063,0,5089,3.0,10,0.2
2025-08-18T11:50:48.245779,0,5089,3.0,10,2.6
2025-08-18T11:50:48.746368,0,5089,3.0,10,0.3
2025-08-18T11:50:49.246745,0,5089,3.0,10,0.8
2025-08-18T11:50:49.747436,0,5089,3.0,10,0.9
2025-08-18T11:50:50.247978,0,5089,3.0,10,0.3
2025-08-18T11:50:50.748798,0,5089,3.0,10,0.2
2025-08-18T11:50:51.249483,0,5089,3.0,10,0.2
2025-08-18T11:50:51.750311,0,5089,3.0,10,0.2
2025-08-18T11:50:52.251085,0,5089,3.0,10,0.1
2025-08-18T11:50:52.751887,0,5089,3.0,10,0.2
2025-08-18T11:50:53.252677,0,5089,3.0,10,0.6
2025-08-18T11:50:53.753608,0,5089,3.0,10,0.2
2025-08-18T11:50:54.254411,0,5089,3.0,10,0.2
2025-08-18T11:50:54.755220,0,5089,3.0,10,0.1
2025-08-18T11:50:55.256038,0,5089,3.0,10,0.1
2025-08-18T11:50:55.756818,0,5089,3.0,10,0.1
2025-08-18T11:50:56.257607,0,5089,3.0,10,0.1
2025-08-18T11:50:56.758262,0,5089,3.0,10,0.1
2025-08-18T11:50:57.259104,0,5089,3.0,10,0.1
2025-08-18T11:50:57.760038,0,5089,3.0,10,0.2
2025-08-18T11:50:58.260776,0,5089,3.0,10,0.4
2025-08-18T11:50:58.761585,0,5089,3.0,10,0.1
2025-08-18T11:50:59.262321,0,5089,3.0,10,0.7
2025-08-18T11:50:59.763135,0,5089,3.0,10,0.3
2025-08-18T11:51:00.263913,0,5089,3.0,10,0.2
2025-08-18T11:51:00.764645,0,5089,3.0,10,0.1
2025-08-18T11:51:01.265240,0,5089,3.0,10,0.3
2025-08-18T11:51:01.766029,0,5089,3.0,10,0.2
2025-08-18T11:51:02.266812,0,5089,3.0,10,0.1
2025-08-18T11:51:02.767640,0,5089,3.0,10,0.1
2025-08-18T11:51:03.268347,0,5089,3.0,10,0.3
2025-08-18T11:51:03.769067,0,5089,3.0,10,0.2
2025-08-18T11:51:04.269804,0,5089,3.0,10,0.2
2025-08-18T11:51:04.770359,0,5089,3.0,10,0.1
2025-08-18T11:51:05.271051,0,5089,3.0,10,0.3
2025-08-18T11:51:05.771834,0,5089,3.0,10,0.2
2025-08-18T11:51:06.272500,0,5089,3.0,10,0.1
2025-08-18T11:51:06.773291,0,5089,3.0,10,0.2
2025-08-18T11:51:07.273987,0,5089,3.0,10,0.1
2025-08-18T11:51:07.774766,0,5089,3.0,10,0.1
2025-08-18T11:51:08.275493,0,5089,3.0,10,0.1
2025-08-18T11:51:08.776185,0,5089,3.0,10,0.3
2025-08-18T11:51:09.276911,0,5089,3.0,10,0.1
2025-08-18T11:51:09.777600,0,5089,3.0,10,0.2
2025-08-18T11:51:10.278241,0,5089,3.0,10,0.1
2025-08-18T11:51:10.778984,0,5089,3.0,10,0.2
2025-08-18T11:51:11.279817,0,5089,3.0,10,0.2
2025-08-18T11:51:11.780498,0,5089,3.0,10,0.1
2025-08-18T11:51:12.281269,0,5089,3.0,10,0.2
2025-08-18T11:51:12.782060,0,5089,3.0,10,0.1
2025-08-18T11:51:13.282826,0,5089,3.0,10,0.6
2025-08-18T11:51:13.783449,0,5089,3.0,10,0.1
2025-08-18T11:51:14.284178,0,5089,3.0,10,1.9
2025-08-18T11:51:14.784933,0,5089,3.0,10,0.2
2025-08-18T11:51:15.285689,0,5089,3.0,10,0.4
2025-08-18T11:51:15.786542,0,5089,3.0,10,0.2
2025-08-18T11:51:16.287343,0,5089,3.0,10,0.3
2025-08-18T11:51:16.788075,0,5089,3.0,10,0.2
2025-08-18T11:51:17.288822,0,5089,3.0,10,0.3
2025-08-18T11:51:17.789560,0,5089,3.0,10,0.1
2025-08-18T11:51:18.290344,0,5089,3.0,10,0.2
2025-08-18T11:51:18.791017,0,5089,3.0,10,0.1
2025-08-18T11:51:19.291726,0,5089,3.0,10,0.2
2025-08-18T11:51:19.792555,0,5089,3.0,10,0.2
2025-08-18T11:51:20.293398,0,5089,3.0,10,0.1
2025-08-18T11:51:20.794173,0,5089,3.0,10,0.2
2025-08-18T11:51:21.294920,0,5089,3.0,10,0.1
2025-08-18T11:51:21.795674,0,5089,3.0,10,0.2
2025-08-18T11:51:22.296359,0,5089,3.0,10,0.1
2025-08-18T11:51:22.797123,0,5089,3.0,10,0.2
2025-08-18T11:51:23.297925,0,5089,3.0,10,0.0
2025-08-18T11:51:23.798641,0,5089,3.0,10,0.1
2025-08-18T11:51:24.299242,0,5089,3.0,10,0.2
2025-08-18T11:51:24.799981,0,5089,3.0,10,0.1
2025-08-18T11:51:25.300858,0,5089,3.0,10,0.1
2025-08-18T11:51:25.801638,0,5089,3.0,10,0.2
2025-08-18T11:51:26.302275,0,5089,3.0,10,0.1
2025-08-18T11:51:26.802991,0,5089,3.0,10,0.1
2025-08-18T11:51:27.303735,0,5089,3.0,10,0.1
2025-08-18T11:51:27.804452,0,5089,3.0,10,0.2
2025-08-18T11:51:28.305239,0,5089,3.0,10,0.2
2025-08-18T11:51:28.806047,0,5089,3.0,10,0.1
2025-08-18T11:51:29.306991,0,5089,3.0,10,0.2
2025-08-18T11:51:29.807847,0,5089,3.0,10,0.2
2025-08-18T11:51:30.308755,0,5089,3.0,10,0.1
2025-08-18T11:51:30.809553,0,5089,3.0,10,0.2
2025-08-18T11:51:31.310376,0,5089,3.0,10,0.1
2025-08-18T11:51:31.811147,0,5089,3.0,10,0.1
2025-08-18T11:51:32.311947,0,5089,3.0,10,0.1
2025-08-18T11:51:32.812775,0,5089,3.0,10,0.1
2025-08-18T11:51:33.313636,0,5089,3.0,10,0.1
2025-08-18T11:51:33.814446,0,5089,3.0,10,0.1
2025-08-18T11:51:34.315221,0,5089,3.0,10,0.2
2025-08-18T11:51:34.815975,0,5089,3.0,10,0.1
2025-08-18T11:51:35.316803,0,5089,3.0,10,0.1
2025-08-18T11:51:35.817632,0,5089,3.0,10,0.2
2025-08-18T11:51:36.318412,0,5089,3.0,10,0.1
2025-08-18T11:51:36.819181,0,5089,3.0,10,0.2
2025-08-18T11:51:37.319998,0,5089,3.0,10,0.1
2025-08-18T11:51:37.820709,0,5089,3.0,10,0.1
2025-08-18T11:51:38.321368,0,5089,3.0,10,0.1
2025-08-18T11:51:38.822093,0,5089,3.0,10,0.2
2025-08-18T11:51:39.322888,0,5089,3.0,10,0.2
2025-08-18T11:51:39.823662,0,5089,3.0,10,0.2
2025-08-18T11:51:40.324396,0,5089,3.0,10,0.1
2025-08-18T11:51:40.825177,0,5089,3.0,10,0.2
2025-08-18T11:51:41.325980,0,5089,3.0,10,0.1
2025-08-18T11:51:41.826780,0,5089,3.0,10,0.1
2025-08-18T11:51:42.327610,0,5089,3.0,10,0.1
2025-08-18T11:51:42.828473,0,5089,3.0,10,0.0
2025-08-18T11:51:43.329330,0,5089,3.0,10,0.6
2025-08-18T11:51:43.830101,0,5089,3.0,10,0.3
2025-08-18T11:51:44.330916,0,5089,3.0,10,0.9
2025-08-18T11:51:44.831571,0,5089,3.0,10,0.2
2025-08-18T11:51:45.332294,0,5089,3.0,10,0.4
2025-08-18T11:51:45.833021,0,5089,3.0,10,0.1
2025-08-18T11:51:46.333762,0,5089,3.0,10,0.2
2025-08-18T11:51:46.834542,0,5089,3.0,10,0.1
2025-08-18T11:51:47.335236,0,5089,3.0,10,0.1
2025-08-18T11:51:47.835951,0,5089,3.0,10,0.1
2025-08-18T11:51:48.336660,0,5089,3.0,10,0.2
2025-08-18T11:51:48.837449,0,5089,3.0,10,0.2
2025-08-18T11:51:49.338210,0,5089,3.0,10,0.5
2025-08-18T11:51:49.838970,0,5089,3.0,10,0.1
2025-08-18T11:51:50.339743,0,5089,3.0,10,0.2
2025-08-18T11:51:50.840474,0,5089,3.0,10,0.2
2025-08-18T11:51:51.341229,0,5089,3.0,10,0.1
2025-08-18T11:51:51.842037,0,5089,3.0,10,0.2
2025-08-18T11:51:52.342749,0,5089,3.0,10,0.1
2025-08-18T11:51:52.843500,0,5089,3.0,10,0.2
2025-08-18T11:51:53.344272,0,5089,3.0,10,0.1
2025-08-18T11:51:53.844932,0,5089,3.0,10,0.1
2025-08-18T11:51:54.345636,0,5089,3.0,10,0.2
2025-08-18T11:51:54.846307,0,5089,3.0,10,0.1
2025-08-18T11:51:55.346935,0,5089,3.0,10,0.1
2025-08-18T11:51:55.847557,0,5089,3.0,10,0.1
2025-08-18T11:51:56.348292,0,5089,3.0,10,0.1
2025-08-18T11:51:56.848978,0,5089,3.0,10,0.1
2025-08-18T11:51:57.349634,0,5089,3.0,10,0.1
2025-08-18T11:51:57.850411,0,5089,3.0,10,0.1
2025-08-18T11:51:58.351246,0,5089,3.0,10,0.2
2025-08-18T11:51:58.852084,0,5089,3.0,10,0.1
2025-08-18T11:51:59.352860,0,5089,3.0,10,0.8
2025-08-18T11:51:59.853802,0,5089,3.0,10,0.1
2025-08-18T11:52:00.354484,0,5089,3.0,10,0.4
2025-08-18T11:52:00.855202,0,5089,3.0,10,0.1
2025-08-18T11:52:01.355949,0,5089,3.0,10,0.2
2025-08-18T11:52:01.856799,0,5089,3.0,10,0.2
2025-08-18T11:52:02.357589,0,5089,3.0,10,0.1
2025-08-18T11:52:02.858324,0,5089,3.0,10,0.2
2025-08-18T11:52:03.359057,0,5089,3.0,10,0.5
2025-08-18T11:52:03.859739,0,5089,3.0,10,0.1
2025-08-18T11:52:04.360423,0,5089,3.0,10,0.4
2025-08-18T11:52:04.861181,0,5089,3.0,10,0.1
2025-08-18T11:52:05.361919,0,5089,3.0,10,0.1
2025-08-18T11:52:05.862743,0,5089,3.0,10,0.1
2025-08-18T11:52:06.363613,0,5089,3.0,10,0.1
2025-08-18T11:52:06.864328,0,5089,3.0,10,0.1
2025-08-18T11:52:07.364966,0,5089,3.0,10,0.2
2025-08-18T11:52:07.865760,0,5089,3.0,10,0.1
2025-08-18T11:52:08.366414,0,5089,3.0,10,0.2
2025-08-18T11:52:08.867168,0,5089,3.0,10,0.2
2025-08-18T11:52:09.367971,0,5089,3.0,10,0.2
2025-08-18T11:52:09.868819,0,5089,3.0,10,0.1
2025-08-18T11:52:10.369663,0,5089,3.0,10,0.1
2025-08-18T11:52:10.870424,0,5089,3.0,10,0.2
2025-08-18T11:52:11.371272,0,5089,3.0,10,0.1
2025-08-18T11:52:11.872039,0,5089,3.0,10,0.1
2025-08-18T11:52:12.372822,0,5089,3.0,10,0.1
2025-08-18T11:52:12.873631,0,5089,3.0,10,0.2
2025-08-18T11:52:13.374362,0,5089,3.0,10,0.5
2025-08-18T11:52:13.875048,0,5089,3.0,10,0.2
2025-08-18T11:52:14.375732,0,5089,3.0,10,0.6
2025-08-18T11:52:14.876563,0,5089,3.0,10,0.1
2025-08-18T11:52:15.377365,0,5089,3.0,10,0.4
2025-08-18T11:52:15.878122,0,5089,3.0,10,0.2
2025-08-18T11:52:16.378928,0,5089,3.0,10,0.3
2025-08-18T11:52:16.879668,0,5089,3.0,10,0.2
2025-08-18T11:52:17.380340,0,5089,3.0,10,0.2
2025-08-18T11:52:17.881127,0,5089,3.0,10,0.1
2025-08-18T11:52:18.381798,0,5089,3.0,10,0.2
2025-08-18T11:52:18.882563,0,5089,3.0,10,0.2
2025-08-18T11:52:19.383265,0,5089,3.0,10,0.4
2025-08-18T11:52:19.883994,0,5089,3.0,10,0.1
2025-08-18T11:52:20.384702,0,5089,3.0,10,0.1
2025-08-18T11:52:20.885430,0,5089,3.0,10,0.1
2025-08-18T11:52:21.386169,0,5089,3.0,10,0.2
2025-08-18T11:52:21.886971,0,5089,3.0,10,0.1
2025-08-18T11:52:22.387599,0,5089,3.0,10,0.2
2025-08-18T11:52:22.888323,0,5089,3.0,10,0.1
2025-08-18T11:52:23.389068,0,5089,3.0,10,0.1
2025-08-18T11:52:23.889947,0,5089,3.0,10,0.2
2025-08-18T11:52:24.390643,0,5089,3.0,10,2.4
2025-08-18T11:52:24.891328,0,5089,3.0,10,0.1
2025-08-18T11:52:25.392054,0,5089,3.0,10,0.1
2025-08-18T11:52:25.892821,0,5089,3.0,10,0.2
2025-08-18T11:52:26.393611,0,5089,3.0,10,0.1
2025-08-18T11:52:26.894253,0,5089,3.0,10,0.1
2025-08-18T11:52:27.394982,0,5089,3.0,10,0.2
2025-08-18T11:52:27.895684,0,5089,3.0,10,0.1
2025-08-18T11:52:28.396346,0,5089,3.0,10,0.1
2025-08-18T11:52:28.897065,0,5089,3.0,10,0.1
2025-08-18T11:52:29.397775,0,5089,3.0,10,0.2
2025-08-18T11:52:29.898497,0,5089,3.0,10,0.0
2025-08-18T11:52:30.399242,0,5089,3.0,10,0.2
2025-08-18T11:52:30.899933,0,5089,3.0,10,0.1
2025-08-18T11:52:31.400681,0,5089,3.0,10,0.1
2025-08-18T11:52:31.901460,0,5089,3.0,10,0.1
2025-08-18T11:52:32.402227,0,5089,3.0,10,0.1
2025-08-18T11:52:32.903022,0,5089,3.0,10,0.2
2025-08-18T11:52:33.403884,0,5089,3.0,10,0.1
2025-08-18T11:52:33.904707,0,5089,3.0,10,0.1
2025-08-18T11:52:34.405574,0,5089,3.0,10,0.1
2025-08-18T11:52:34.906424,0,5089,3.0,10,0.1
2025-08-18T11:52:35.407245,0,5089,3.0,10,0.1
2025-08-18T11:52:35.908036,0,5089,3.0,10,0.1
2025-08-18T11:52:36.409004,0,5089,3.0,10,0.2
2025-08-18T11:52:36.909825,0,5089,3.0,10,0.1
2025-08-18T11:52:37.410657,0,5089,3.0,10,0.2
2025-08-18T11:52:37.911603,0,5089,3.0,10,0.1
2025-08-18T11:52:38.412549,0,5089,3.0,10,0.1
2025-08-18T11:52:38.913360,0,5089,3.0,10,0.2
2025-08-18T11:52:39.414066,0,5089,3.0,10,0.2
2025-08-18T11:52:39.914876,0,5089,3.0,10,0.2
2025-08-18T11:52:40.415723,0,5089,3.0,10,0.1
2025-08-18T11:52:40.916561,0,5089,3.0,10,0.1
2025-08-18T11:52:41.417359,0,5089,3.0,10,0.3
2025-08-18T11:52:41.918131,0,5089,3.0,10,0.1
2025-08-18T11:52:42.418990,0,5089,3.0,10,0.2
2025-08-18T11:52:42.919976,0,5089,3.0,10,0.1
2025-08-18T11:52:43.420846,0,5089,3.0,10,0.5
2025-08-18T11:52:43.921577,0,5089,3.0,10,0.2
2025-08-18T11:52:44.422270,0,5089,3.0,10,0.8
2025-08-18T11:52:44.923007,0,5089,3.0,10,0.1
2025-08-18T11:52:45.423712,0,5089,3.0,10,0.3
2025-08-18T11:52:45.924448,0,5089,3.0,10,0.2
2025-08-18T11:52:46.425240,0,5089,3.0,10,0.3
2025-08-18T11:52:46.925993,0,5089,3.0,10,0.2
2025-08-18T11:52:47.426769,0,5089,3.0,10,0.1
2025-08-18T11:52:47.927547,0,5089,3.0,10,0.2
2025-08-18T11:52:48.428260,0,5089,3.0,10,0.4
2025-08-18T11:52:48.929033,0,5089,3.0,10,0.1
2025-08-18T11:52:49.429871,0,5089,3.0,10,0.4
2025-08-18T11:52:49.930592,0,5089,3.0,10,0.2
2025-08-18T11:52:50.431366,0,5089,3.0,10,0.1
2025-08-18T11:52:50.932073,0,5089,3.0,10,0.1
2025-08-18T11:52:51.432845,0,5089,3.0,10,0.0
2025-08-18T11:52:51.933574,0,5089,3.0,10,0.1
2025-08-18T11:52:52.434175,0,5089,3.0,10,0.2
2025-08-18T11:52:52.934946,0,5089,3.0,10,0.1
2025-08-18T11:52:53.435688,0,5089,3.0,10,0.2
2025-08-18T11:52:53.936332,0,5089,3.0,10,0.1
2025-08-18T11:52:54.437061,0,5089,3.0,10,0.1
2025-08-18T11:52:54.937670,0,5089,3.0,10,0.1
2025-08-18T11:52:55.438290,0,5089,3.0,10,0.1
2025-08-18T11:52:55.938987,0,5089,3.0,10,0.1
2025-08-18T11:52:56.439621,0,5089,3.0,10,0.1
2025-08-18T11:52:56.940244,0,5089,3.0,10,0.2
2025-08-18T11:52:57.441035,0,5089,3.0,10,0.1
2025-08-18T11:52:57.941752,0,5089,3.0,10,0.1
2025-08-18T11:52:58.442367,0,5089,3.0,10,0.2
2025-08-18T11:52:58.943099,0,5089,3.0,10,0.1
2025-08-18T11:52:59.443830,0,5089,3.0,10,0.9
2025-08-18T11:52:59.944571,0,5089,3.0,10,0.2
2025-08-18T11:53:00.445288,0,5089,3.0,10,0.1
2025-08-18T11:53:00.945968,0,5089,3.0,10,0.3
2025-08-18T11:53:01.446730,0,5089,3.0,10,0.1
2025-08-18T11:53:01.947364,0,5089,3.0,10,0.2
2025-08-18T11:53:02.448086,0,5089,3.0,10,0.1
2025-08-18T11:53:02.948834,0,5089,3.0,10,0.1
2025-08-18T11:53:03.449581,0,5089,3.0,10,0.4
2025-08-18T11:53:03.950279,0,5089,3.0,10,0.1
2025-08-18T11:53:04.451065,0,5089,3.0,10,0.2
2025-08-18T11:53:04.951782,0,5089,3.0,10,0.2
2025-08-18T11:53:05.452447,0,5089,3.0,10,0.1
2025-08-18T11:53:05.953057,0,5089,3.0,10,0.1
2025-08-18T11:53:06.453883,0,5089,3.0,10,0.1
2025-08-18T11:53:06.954604,0,5089,3.0,10,0.1
2025-08-18T11:53:07.455422,0,5089,3.0,10,0.2
2025-08-18T11:53:07.956227,0,5089,3.0,10,0.1
2025-08-18T11:53:08.456982,0,5089,3.0,10,0.2
2025-08-18T11:53:08.957808,0,5089,3.0,10,0.2
2025-08-18T11:53:09.458639,0,5089,3.0,10,0.1
2025-08-18T11:53:09.959434,0,5089,3.0,10,0.1
2025-08-18T11:53:10.460260,0,5089,3.0,10,0.2
2025-08-18T11:53:10.961068,0,5089,3.0,10,0.2
2025-08-18T11:53:11.461913,0,5089,3.0,10,0.2
2025-08-18T11:53:11.962726,0,5089,3.0,10,0.2
2025-08-18T11:53:12.463605,0,5089,3.0,10,0.1
2025-08-18T11:53:12.964411,0,5089,3.0,10,0.1
2025-08-18T11:53:13.465049,0,5089,3.0,10,0.5
2025-08-18T11:53:13.965898,0,5089,3.0,10,0.1
2025-08-18T11:53:14.466396,0,5089,3.0,10,0.7
2025-08-18T11:53:14.967180,0,5089,3.0,10,0.3
2025-08-18T11:53:15.467936,0,5089,3.0,10,0.2
2025-08-18T11:53:15.968802,0,5089,3.0,10,0.3
2025-08-18T11:53:16.469469,0,5089,3.0,10,0.4
2025-08-18T11:53:16.970342,0,5089,3.0,10,0.1
2025-08-18T11:53:17.471133,0,5089,3.0,10,0.1
2025-08-18T11:53:17.971949,0,5089,3.0,10,0.1
2025-08-18T11:53:18.472789,0,5089,3.0,10,0.1
2025-08-18T11:53:18.973618,0,5089,3.0,10,0.2
2025-08-18T11:53:19.474388,0,5089,3.0,10,0.3
2025-08-18T11:53:19.975203,0,5089,3.0,10,0.1
2025-08-18T11:53:20.476053,0,5089,3.0,10,0.1
2025-08-18T11:53:20.976886,0,5089,3.0,10,0.2
2025-08-18T11:53:21.477746,0,5089,3.0,10,0.1
2025-08-18T11:53:21.978592,0,5089,3.0,10,0.1
2025-08-18T11:53:22.479371,0,5089,3.0,10,0.1
2025-08-18T11:53:22.980190,0,5089,3.0,10,0.3
2025-08-18T11:53:23.480989,0,5089,3.0,10,0.2
2025-08-18T11:53:23.981822,0,5089,3.0,10,0.1
2025-08-18T11:53:24.482629,0,5089,3.0,10,0.2
2025-08-18T11:53:24.983425,0,5089,3.0,10,0.2
2025-08-18T11:53:25.484254,0,5089,3.0,10,0.1
2025-08-18T11:53:25.985086,0,5089,3.0,10,0.1
2025-08-18T11:53:26.485967,0,5089,3.0,10,0.1
2025-08-18T11:53:26.986788,0,5089,3.0,10,0.2
2025-08-18T11:53:27.487631,0,5089,3.0,10,0.2
2025-08-18T11:53:27.988468,0,5089,3.0,10,0.1
2025-08-18T11:53:28.489322,0,5089,3.0,10,0.2
2025-08-18T11:53:28.990103,0,5089,3.0,10,0.1
2025-08-18T11:53:29.490936,0,5089,3.0,10,0.1
2025-08-18T11:53:29.991745,0,5089,3.0,10,0.1
2025-08-18T11:53:30.492585,0,5089,3.0,10,0.1
2025-08-18T11:53:30.993455,0,5089,3.0,10,0.1
2025-08-18T11:53:31.494334,0,5089,3.0,10,0.2
2025-08-18T11:53:31.995097,0,5089,3.0,10,0.2
2025-08-18T11:53:32.495875,0,5089,3.0,10,0.1
2025-08-18T11:53:32.996737,0,5089,3.0,10,0.2
2025-08-18T11:53:33.497554,0,5089,3.0,10,0.1
2025-08-18T11:53:33.998342,0,5089,3.0,10,0.1
2025-08-18T11:53:34.499181,0,5089,3.0,10,1.8
2025-08-18T11:53:35.000060,0,5089,3.0,10,0.1
2025-08-18T11:53:35.500939,0,5089,3.0,10,0.2
2025-08-18T11:53:36.001835,0,5089,3.0,10,0.1
2025-08-18T11:53:36.502588,0,5089,3.0,10,0.2
2025-08-18T11:53:37.003388,0,5089,3.0,10,0.1
2025-08-18T11:53:37.504162,0,5089,3.0,10,0.1
2025-08-18T11:53:38.004966,0,5089,3.0,10,0.2
2025-08-18T11:53:38.505802,0,5089,3.0,10,0.1
2025-08-18T11:53:39.006619,0,5089,3.0,10,0.1
2025-08-18T11:53:39.507402,0,5089,3.0,10,0.3
2025-08-18T11:53:40.008229,0,5089,3.0,10,0.2
2025-08-18T11:53:40.509036,0,5089,3.0,10,0.0
2025-08-18T11:53:41.009878,0,5089,3.0,10,0.2
2025-08-18T11:53:41.510701,0,5089,3.0,10,0.1
2025-08-18T11:53:42.011650,0,5089,3.0,10,0.1
2025-08-18T11:53:42.512344,0,5089,3.0,10,0.2
2025-08-18T11:53:43.013186,0,5089,3.0,10,0.1
2025-08-18T11:53:43.513929,0,5089,3.0,10,0.1
2025-08-18T11:53:44.014719,0,5089,3.0,10,0.6
2025-08-18T11:53:44.515359,0,5089,3.0,10,0.2
2025-08-18T11:53:45.016075,0,5089,3.0,10,0.6
2025-08-18T11:53:45.516837,0,5089,3.0,10,0.1
2025-08-18T11:53:46.017675,0,5089,3.0,10,0.4
2025-08-18T11:53:46.518543,0,5089,3.0,10,0.2
2025-08-18T11:53:47.019343,0,5089,3.0,10,0.3
2025-08-18T11:53:47.520104,0,5089,3.0,10,0.1
2025-08-18T11:53:48.020962,0,5089,3.0,10,0.2
2025-08-18T11:53:48.521733,0,5089,3.0,10,0.4
2025-08-18T11:53:49.022329,0,5089,3.0,10,0.4
2025-08-18T11:53:49.523129,0,5089,3.0,10,0.1
2025-08-18T11:53:50.023917,0,5089,3.0,10,0.2
2025-08-18T11:53:50.524746,0,5089,3.0,10,0.1
2025-08-18T11:53:51.025606,0,5089,3.0,10,0.2
2025-08-18T11:53:51.526358,0,5089,3.0,10,0.1
2025-08-18T11:53:52.027152,0,5089,3.0,10,0.2
2025-08-18T11:53:52.528004,0,5089,3.0,10,0.1
2025-08-18T11:53:53.028799,0,5089,3.0,10,0.2
2025-08-18T11:53:53.529574,0,5089,3.0,10,0.1
2025-08-18T11:53:54.030347,0,5089,3.0,10,0.1
2025-08-18T11:53:54.531158,0,5089,3.0,10,0.3
2025-08-18T11:53:55.032026,0,5089,3.0,10,0.1
2025-08-18T11:53:55.532795,0,5089,3.0,10,0.1
2025-08-18T11:53:56.033568,0,5089,3.0,10,0.2
2025-08-18T11:53:56.534211,0,5089,3.0,10,0.2
2025-08-18T11:53:57.035053,0,5089,3.0,10,0.2
2025-08-18T11:53:57.535895,0,5089,3.0,10,0.1
2025-08-18T11:53:58.036685,0,5089,3.0,10,0.1
2025-08-18T11:53:58.537440,0,5089,3.0,10,0.1
2025-08-18T11:53:59.038195,0,5089,3.0,10,0.1
2025-08-18T11:53:59.539024,0,5089,3.0,10,1.0
2025-08-18T11:54:00.039798,0,5089,3.0,10,0.1
2025-08-18T11:54:00.540609,0,5089,3.0,10,0.2
2025-08-18T11:54:01.041489,0,5089,3.0,10,0.3
2025-08-18T11:54:01.542291,0,5089,3.0,10,0.1
2025-08-18T11:54:02.043117,0,5089,3.0,10,0.2
2025-08-18T11:54:02.543976,0,5089,3.0,10,0.2
2025-08-18T11:54:03.044739,0,5089,3.0,10,0.1
2025-08-18T11:54:03.545584,0,5089,3.0,10,0.6
2025-08-18T11:54:04.046354,0,5089,3.0,10,0.1
2025-08-18T11:54:04.547098,0,5089,3.0,10,0.3
2025-08-18T11:54:05.047877,0,5089,3.0,10,0.1
2025-08-18T11:54:05.548764,0,5089,3.0,10,0.2
2025-08-18T11:54:06.049432,0,5089,3.0,10,0.2
2025-08-18T11:54:06.550187,0,5089,3.0,10,0.1
2025-08-18T11:54:07.051009,0,5089,3.0,10,0.1
2025-08-18T11:54:07.551845,0,5089,3.0,10,0.2
2025-08-18T11:54:08.052716,0,5089,3.0,10,0.1
2025-08-18T11:54:08.553357,0,5089,3.0,10,0.1
2025-08-18T11:54:09.053997,0,5089,3.0,10,0.1
2025-08-18T11:54:09.554677,0,5089,3.0,10,0.2
2025-08-18T11:54:10.055287,0,5089,3.0,10,0.1
2025-08-18T11:54:10.555747,0,5089,3.0,10,0.2
2025-08-18T11:54:11.056448,0,5089,3.0,10,0.2
2025-08-18T11:54:11.557242,0,5089,3.0,10,0.2
2025-08-18T11:54:12.058043,0,5089,3.0,10,0.1
2025-08-18T11:54:12.558902,0,5089,3.0,10,0.2
2025-08-18T11:54:13.059777,0,5089,3.0,10,0.1
2025-08-18T11:54:13.560638,0,5089,3.0,10,0.1
2025-08-18T11:54:14.061357,0,5089,3.0,10,0.4
2025-08-18T11:54:14.562089,0,5089,3.0,10,0.2
2025-08-18T11:54:15.062862,0,5089,3.0,10,0.7
2025-08-18T11:54:15.563635,0,5089,3.0,10,0.1
2025-08-18T11:54:16.064452,0,5089,3.0,10,0.4
2025-08-18T11:54:16.565170,0,5089,3.0,10,0.1
2025-08-18T11:54:17.065955,0,5089,3.0,10,0.3
2025-08-18T11:54:17.566706,0,5089,3.0,10,0.2
2025-08-18T11:54:18.067369,0,5089,3.0,10,0.3
2025-08-18T11:54:18.568084,0,5089,3.0,10,0.2
2025-08-18T11:54:19.068852,0,5089,3.0,10,0.2
2025-08-18T11:54:19.569706,0,5089,3.0,10,0.3
2025-08-18T11:54:20.070440,0,5089,3.0,10,0.1
2025-08-18T11:54:20.571120,0,5089,3.0,10,0.1
2025-08-18T11:54:21.071814,0,5089,3.0,10,0.1
2025-08-18T11:54:21.572479,0,5089,3.0,10,0.1
2025-08-18T11:54:22.073258,0,5089,3.0,10,0.1
2025-08-18T11:54:22.573980,0,5089,3.0,10,0.1
2025-08-18T11:54:23.074690,0,5089,3.0,10,0.2
2025-08-18T11:54:23.575589,0,5089,3.0,10,0.1
2025-08-18T11:54:24.076442,0,5089,3.0,10,0.2
2025-08-18T11:54:24.577235,0,5089,3.0,10,0.2
2025-08-18T11:54:25.078007,0,5089,3.0,10,0.2
2025-08-18T11:54:25.578851,0,5089,3.0,10,0.1
2025-08-18T11:54:26.079672,0,5089,3.0,10,0.1
2025-08-18T11:54:26.580451,0,5089,3.0,10,0.1
2025-08-18T11:54:27.081261,0,5089,3.0,10,0.1
2025-08-18T11:54:27.582039,0,5089,3.0,10,0.2
2025-08-18T11:54:28.082863,0,5089,3.0,10,0.1
2025-08-18T11:54:28.583655,0,5089,3.0,10,0.2
2025-08-18T11:54:29.084282,0,5089,3.0,10,0.2
2025-08-18T11:54:29.585074,0,5089,3.0,10,0.2
2025-08-18T11:54:30.085796,0,5089,3.0,10,0.2
2025-08-18T11:54:30.586617,0,5089,3.0,10,0.0
2025-08-18T11:54:31.087347,0,5089,3.0,10,0.1
2025-08-18T11:54:31.588028,0,5089,3.0,10,0.1
2025-08-18T11:54:32.088771,0,5089,3.0,10,0.2
2025-08-18T11:54:32.589467,0,5089,3.0,10,0.1
2025-08-18T11:54:33.090206,0,5089,3.0,10,0.1
2025-08-18T11:54:33.590996,0,5089,3.0,10,0.1
2025-08-18T11:54:34.091791,0,5089,3.0,10,0.1
2025-08-18T11:54:34.592543,0,5089,3.0,10,0.2
2025-08-18T11:54:35.093242,0,5089,3.0,10,0.1
2025-08-18T11:54:35.593968,0,5089,3.0,10,0.1
2025-08-18T11:54:36.094790,0,5089,3.0,10,0.1
2025-08-18T11:54:36.595553,0,5089,3.0,10,0.1
2025-08-18T11:54:37.096282,0,5089,3.0,10,0.2
2025-08-18T11:54:37.596962,0,5089,3.0,10,0.1
2025-08-18T11:54:38.097758,0,5089,3.0,10,0.2
2025-08-18T11:54:38.598353,0,5089,3.0,10,0.1
2025-08-18T11:54:39.099209,0,5089,3.0,10,0.1
2025-08-18T11:54:39.599926,0,5089,3.0,10,0.3
2025-08-18T11:54:40.100671,0,5089,3.0,10,0.2
2025-08-18T11:54:40.601384,0,5089,3.0,10,0.1
2025-08-18T11:54:41.102068,0,5089,3.0,10,0.2
2025-08-18T11:54:41.602826,0,5089,3.0,10,0.1
2025-08-18T11:54:42.103601,0,5089,3.0,10,0.1
2025-08-18T11:54:42.604299,0,5089,3.0,10,0.1
2025-08-18T11:54:43.104991,0,5089,3.0,10,0.1
2025-08-18T11:54:43.605780,0,5089,3.0,10,0.2
2025-08-18T11:54:44.106411,0,5089,3.0,10,0.6
2025-08-18T11:54:44.607036,0,5089,3.0,10,0.2
2025-08-18T11:54:45.107769,0,5089,3.0,10,1.8
2025-08-18T11:54:45.608483,0,5089,3.0,10,0.1
2025-08-18T11:54:46.109226,0,5089,3.0,10,0.4
2025-08-18T11:54:46.609898,0,5089,3.0,10,0.2
2025-08-18T11:54:47.110705,0,5089,3.0,10,0.3
2025-08-18T11:54:47.611466,0,5089,3.0,10,0.1
2025-08-18T11:54:48.112166,0,5089,3.0,10,0.3
2025-08-18T11:54:48.612872,0,5089,3.0,10,0.4
2025-08-18T11:54:49.113583,0,5089,3.0,10,0.4
2025-08-18T11:54:49.614258,0,5089,3.0,10,0.2
2025-08-18T11:54:50.114957,0,5089,3.0,10,0.2
2025-08-18T11:54:50.615744,0,5089,3.0,10,0.1
2025-08-18T11:54:51.116430,0,5089,3.0,10,0.2
2025-08-18T11:54:51.617185,0,5089,3.0,10,0.1
2025-08-18T11:54:52.117933,0,5089,3.0,10,0.1
2025-08-18T11:54:52.618561,0,5089,3.0,10,0.2
2025-08-18T11:54:53.119239,0,5089,3.0,10,0.1
2025-08-18T11:54:53.619890,0,5089,3.0,10,0.1
2025-08-18T11:54:54.120568,0,5089,3.0,10,0.2
2025-08-18T11:54:54.621219,0,5089,3.0,10,0.2
2025-08-18T11:54:55.122001,0,5089,3.0,10,0.2
2025-08-18T11:54:55.622675,0,5089,3.0,10,0.1
2025-08-18T11:54:56.123351,0,5089,3.0,10,0.1
2025-08-18T11:54:56.624102,0,5089,3.0,10,0.2
2025-08-18T11:54:57.124913,0,5089,3.0,10,0.1
2025-08-18T11:54:57.625581,0,5089,3.0,10,0.2
2025-08-18T11:54:58.126232,0,5089,3.0,10,0.1
2025-08-18T11:54:58.627013,0,5089,3.0,10,0.2
2025-08-18T11:54:59.127680,0,5089,3.0,10,0.1
2025-08-18T11:54:59.628369,0,5089,3.0,10,0.8
2025-08-18T11:55:00.129176,0,5089,3.0,10,0.1
2025-08-18T11:55:00.629973,0,5089,3.0,10,0.2
2025-08-18T11:55:01.130676,0,5089,3.0,10,0.2
2025-08-18T11:55:01.631352,0,5089,3.0,10,0.2
2025-08-18T11:55:02.132053,0,5089,3.0,10,0.2
2025-08-18T11:55:02.632865,0,5089,3.0,10,0.2
2025-08-18T11:55:03.133537,0,5089,3.0,10,0.3
2025-08-18T11:55:03.634310,0,5089,3.0,10,0.1
2025-08-18T11:55:04.135080,0,5089,3.0,10,0.1
2025-08-18T11:55:04.635921,0,5089,3.0,10,0.2
2025-08-18T11:55:05.136794,0,5089,3.0,10,0.2
2025-08-18T11:55:05.637543,0,5089,3.0,10,0.1
2025-08-18T11:55:06.138388,0,5089,3.0,10,0.2
2025-08-18T11:55:06.639226,0,5089,3.0,10,0.1
2025-08-18T11:55:07.140050,0,5089,3.0,10,0.2
2025-08-18T11:55:07.640928,0,5089,3.0,10,0.2
2025-08-18T11:55:08.141629,0,5089,3.0,10,0.1
2025-08-18T11:55:08.642455,0,5089,3.0,10,0.2
2025-08-18T11:55:09.143316,0,5089,3.0,10,0.1
2025-08-18T11:55:09.644106,0,5089,3.0,10,0.2
2025-08-18T11:55:10.144928,0,5089,3.0,10,0.1
2025-08-18T11:55:10.645786,0,5089,3.0,10,0.1
2025-08-18T11:55:11.146645,0,5089,3.0,10,0.2
2025-08-18T11:55:11.647437,0,5089,3.0,10,0.1
2025-08-18T11:55:12.148279,0,5089,3.0,10,0.1
2025-08-18T11:55:12.649108,0,5089,3.0,10,0.2
2025-08-18T11:55:13.149955,0,5089,3.0,10,0.1
2025-08-18T11:55:13.650818,0,5089,3.0,10,0.1
2025-08-18T11:55:14.151650,0,5089,3.0,10,0.4
2025-08-18T11:55:14.652450,0,5089,3.0,10,0.2
2025-08-18T11:55:15.153227,0,5089,3.0,10,0.7
2025-08-18T11:55:15.654051,0,5089,3.0,10,0.2
2025-08-18T11:55:16.154854,0,5089,3.0,10,2.0
2025-08-18T11:55:16.655535,0,5089,3.0,10,0.1
2025-08-18T11:55:17.156349,0,5089,3.0,10,0.3
2025-08-18T11:55:17.657355,0,5089,3.0,10,0.2
2025-08-18T11:55:18.158131,0,5089,3.0,10,0.2
2025-08-18T11:55:18.659009,0,5089,3.0,10,0.2
2025-08-18T11:55:19.159879,0,5089,3.0,10,0.1
2025-08-18T11:55:19.660747,0,5089,3.0,10,0.2
2025-08-18T11:55:20.161604,0,5089,3.0,10,0.2
2025-08-18T11:55:20.662273,0,5089,3.0,10,0.1
2025-08-18T11:55:21.163073,0,5089,3.0,10,0.2
2025-08-18T11:55:21.663824,0,5089,3.0,10,0.2
2025-08-18T11:55:22.164579,0,5089,3.0,10,0.1
2025-08-18T11:55:22.665285,0,5089,3.0,10,0.1
2025-08-18T11:55:23.166125,0,5089,3.0,10,0.2
2025-08-18T11:55:23.666951,0,5089,3.0,10,0.1
2025-08-18T11:55:24.167655,0,5089,3.0,10,0.1
2025-08-18T11:55:24.668417,0,5089,3.0,10,0.1
2025-08-18T11:55:25.169229,0,5089,3.0,10,0.2
2025-08-18T11:55:25.670074,0,5089,3.0,10,0.1
2025-08-18T11:55:26.170894,0,5089,3.0,10,0.1
2025-08-18T11:55:26.671692,0,5089,3.0,10,0.1
2025-08-18T11:55:27.172498,0,5089,3.0,10,0.1
2025-08-18T11:55:27.673336,0,5089,3.0,10,0.2
2025-08-18T11:55:28.174185,0,5089,3.0,10,0.1
2025-08-18T11:55:28.675065,0,5089,3.0,10,0.4
2025-08-18T11:55:29.175890,0,5089,3.0,10,0.1
2025-08-18T11:55:29.676697,0,5089,3.0,10,0.2
2025-08-18T11:55:30.177575,0,5089,3.0,10,0.1
2025-08-18T11:55:30.678302,0,5089,3.0,10,0.1
2025-08-18T11:55:31.179136,0,5089,3.0,10,0.1
2025-08-18T11:55:31.679965,0,5089,3.0,10,0.1
2025-08-18T11:55:32.180811,0,5089,3.0,10,0.1
2025-08-18T11:55:32.681602,0,5089,3.0,10,0.2
2025-08-18T11:55:33.182359,0,5089,3.0,10,0.1
2025-08-18T11:55:33.683200,0,5089,3.0,10,0.1
2025-08-18T11:55:34.184013,0,5089,3.0,10,0.1
2025-08-18T11:55:34.684836,0,5089,3.0,10,0.2
2025-08-18T11:55:35.185635,0,5089,3.0,10,0.1
2025-08-18T11:55:35.686276,0,5089,3.0,10,0.1
2025-08-18T11:55:36.187075,0,5089,3.0,10,0.1
2025-08-18T11:55:36.687936,0,5089,3.0,10,0.2
2025-08-18T11:55:37.188804,0,5089,3.0,10,0.1
2025-08-18T11:55:37.689688,0,5089,3.0,10,0.1
2025-08-18T11:55:38.190488,0,5089,3.0,10,0.2
2025-08-18T11:55:38.691298,0,5089,3.0,10,0.1
2025-08-18T11:55:39.192067,0,5089,3.0,10,0.1
2025-08-18T11:55:39.692915,0,5089,3.0,10,0.3
2025-08-18T11:55:40.193610,0,5089,3.0,10,0.1
2025-08-18T11:55:40.694333,0,5089,3.0,10,0.1
2025-08-18T11:55:41.195153,0,5089,3.0,10,0.2
2025-08-18T11:55:41.695827,0,5089,3.0,10,0.1
2025-08-18T11:55:42.196725,0,5089,3.0,10,0.1
2025-08-18T11:55:42.697498,0,5089,3.0,10,0.1
2025-08-18T11:55:43.198337,0,5089,3.0,10,0.1
2025-08-18T11:55:43.699147,0,5089,3.0,10,0.1
2025-08-18T11:55:44.199928,0,5089,3.0,10,0.6
2025-08-18T11:55:44.700778,0,5089,3.0,10,0.2
2025-08-18T11:55:45.201498,0,5089,3.0,10,0.7
2025-08-18T11:55:45.702346,0,5089,3.0,10,0.1
2025-08-18T11:55:46.202947,0,5089,3.0,10,0.4
2025-08-18T11:55:46.703838,0,5089,3.0,10,0.1
2025-08-18T11:55:47.204682,0,5089,3.0,10,0.2
2025-08-18T11:55:47.705478,0,5089,3.0,10,0.2
2025-08-18T11:55:48.206302,0,5089,3.0,10,1.9
2025-08-18T11:55:48.707109,0,5089,3.0,10,0.2
2025-08-18T11:55:49.207696,0,5089,3.0,10,0.7
2025-08-18T11:55:49.708371,0,5089,3.0,10,1.0
2025-08-18T11:55:50.209104,0,5089,3.0,10,0.1
2025-08-18T11:55:50.709849,0,5089,3.0,10,0.1
2025-08-18T11:55:51.210493,0,5089,3.0,10,0.2
2025-08-18T11:55:51.711130,0,5089,3.0,10,0.1
2025-08-18T11:55:52.211922,0,5089,3.0,10,0.1
2025-08-18T11:55:52.712722,0,5089,3.0,10,0.3
2025-08-18T11:55:53.213466,0,5089,3.0,10,0.4
2025-08-18T11:55:53.714186,0,5089,3.0,10,0.2
2025-08-18T11:55:54.214922,0,5089,3.0,10,0.1
2025-08-18T11:55:54.715653,0,5089,3.0,10,0.1
2025-08-18T11:55:55.216224,0,5089,3.0,10,0.1
2025-08-18T11:55:55.716829,0,5089,3.0,10,0.2
2025-08-18T11:55:56.217471,0,5089,3.0,10,0.1
2025-08-18T11:55:56.718326,0,5089,3.0,10,0.2
2025-08-18T11:55:57.219131,0,5089,3.0,10,0.1
2025-08-18T11:55:57.719811,0,5089,3.0,10,0.4
2025-08-18T11:55:58.220538,0,5089,3.0,10,0.4
2025-08-18T11:55:58.721302,0,5089,3.0,10,0.2
2025-08-18T11:55:59.222131,0,5089,3.0,10,0.1
2025-08-18T11:55:59.722976,0,5089,3.0,10,0.9
2025-08-18T11:56:00.223698,0,5089,3.0,10,0.1
2025-08-18T11:56:00.724490,0,5089,3.0,10,0.2
2025-08-18T11:56:01.225288,0,5089,3.0,10,0.3
2025-08-18T11:56:01.726013,0,5089,3.0,10,0.1
2025-08-18T11:56:02.226748,0,5089,3.0,10,0.2
2025-08-18T11:56:02.727390,0,5089,3.0,10,0.1
2025-08-18T11:56:03.228144,0,5089,3.0,10,0.6
2025-08-18T11:56:03.728848,0,5089,3.0,10,0.2
2025-08-18T11:56:04.229760,0,5089,3.0,10,0.0
2025-08-18T11:56:04.730615,0,5089,3.0,10,0.2
2025-08-18T11:56:05.231452,0,5089,3.0,10,0.1
2025-08-18T11:56:05.732265,0,5089,3.0,10,0.2
2025-08-18T11:56:06.233052,0,5089,3.0,10,0.1
2025-08-18T11:56:06.733843,0,5089,3.0,10,0.1
2025-08-18T11:56:07.234793,0,5089,3.0,10,0.1
2025-08-18T11:56:07.735601,0,5089,3.0,10,0.2
2025-08-18T11:56:08.236307,0,5089,3.0,10,0.1
2025-08-18T11:56:08.737027,0,5089,3.0,10,0.1
2025-08-18T11:56:09.237731,0,5089,3.0,10,0.2
2025-08-18T11:56:09.738493,0,5089,3.0,10,0.2
2025-08-18T11:56:10.239445,0,5089,3.0,10,0.2
2025-08-18T11:56:10.740050,0,5089,3.0,10,0.2
2025-08-18T11:56:11.240840,0,5089,3.0,10,0.1
2025-08-18T11:56:11.741566,0,5089,3.0,10,0.1
2025-08-18T11:56:12.242238,0,5089,3.0,10,0.2
2025-08-18T11:56:12.742922,0,5089,3.0,10,0.2
2025-08-18T11:56:13.243609,0,5089,3.0,10,0.1
2025-08-18T11:56:13.744405,0,5089,3.0,10,0.1
2025-08-18T11:56:14.244958,0,5089,3.0,10,0.5
2025-08-18T11:56:14.745542,0,5089,3.0,10,0.3
2025-08-18T11:56:15.245917,0,5089,3.0,10,0.6
2025-08-18T11:56:15.746584,0,5089,3.0,10,0.3
2025-08-18T11:56:16.247351,0,5089,3.0,10,0.3
2025-08-18T11:56:16.748107,0,5089,3.0,10,0.3
2025-08-18T11:56:17.248818,0,5089,3.0,10,0.3
2025-08-18T11:56:17.749447,0,5089,3.0,10,0.1
2025-08-18T11:56:18.250057,0,5089,3.0,10,0.3
2025-08-18T11:56:18.750819,0,5089,3.0,10,0.1
2025-08-18T11:56:19.251618,0,5089,3.0,10,0.2
2025-08-18T11:56:19.752320,0,5089,3.0,10,0.3
2025-08-18T11:56:20.252988,0,5089,3.0,10,0.1
2025-08-18T11:56:20.753774,0,5089,3.0,10,0.1
2025-08-18T11:56:21.254373,0,5089,3.0,10,0.1
2025-08-18T11:56:21.755132,0,5089,3.0,10,0.1
2025-08-18T11:56:22.255873,0,5089,3.0,10,0.2
2025-08-18T11:56:22.756652,0,5089,3.0,10,0.2
2025-08-18T11:56:23.257364,0,5089,3.0,10,0.1
2025-08-18T11:56:23.758088,0,5089,3.0,10,0.1
2025-08-18T11:56:24.258811,0,5089,3.0,10,0.1
2025-08-18T11:56:24.759585,0,5089,3.0,10,0.2
2025-08-18T11:56:25.260272,0,5089,3.0,10,0.1
2025-08-18T11:56:25.760963,0,5089,3.0,10,0.1
2025-08-18T11:56:26.261707,0,5089,3.0,10,0.1
2025-08-18T11:56:26.762392,0,5089,3.0,10,0.1
2025-08-18T11:56:27.263061,0,5089,3.0,10,0.1
2025-08-18T11:56:27.763782,0,5089,3.0,10,0.3
2025-08-18T11:56:28.264544,0,5089,3.0,10,0.1
2025-08-18T11:56:28.765111,0,5089,3.0,10,0.1
2025-08-18T11:56:29.265723,0,5089,3.0,10,0.2
2025-08-18T11:56:29.766323,0,5089,3.0,10,0.1
2025-08-18T11:56:30.267038,0,5089,3.0,10,0.1
2025-08-18T11:56:30.767788,0,5089,3.0,10,0.1
2025-08-18T11:56:31.268357,0,5089,3.0,10,0.2
2025-08-18T11:56:31.769040,0,5089,3.0,10,0.1
2025-08-18T11:56:32.269798,0,5089,3.0,10,0.1
2025-08-18T11:56:32.770574,0,5089,3.0,10,0.1
2025-08-18T11:56:33.271283,0,5089,3.0,10,0.1
2025-08-18T11:56:33.771960,0,5089,3.0,10,0.1
2025-08-18T11:56:34.272672,0,5089,3.0,10,0.2
2025-08-18T11:56:34.773281,0,5089,3.0,10,0.2
2025-08-18T11:56:35.273978,0,5089,3.0,10,0.2
2025-08-18T11:56:35.774638,0,5089,3.0,10,0.1
2025-08-18T11:56:36.275200,0,5089,3.0,10,0.1
2025-08-18T11:56:36.775931,0,5089,3.0,10,0.1
2025-08-18T11:56:37.276559,0,5089,3.0,10,0.1
2025-08-18T11:56:37.777140,0,5089,3.0,10,0.1
2025-08-18T11:56:38.277848,0,5089,3.0,10,0.1
2025-08-18T11:56:38.778413,0,5089,3.0,10,0.1
2025-08-18T11:56:39.279081,0,5089,3.0,10,0.1
2025-08-18T11:56:39.779695,0,5089,3.0,10,0.3
2025-08-18T11:56:40.280244,0,5089,3.0,10,0.2
2025-08-18T11:56:40.780934,0,5089,3.0,10,0.1
2025-08-18T11:56:41.281637,0,5089,3.0,10,0.1
2025-08-18T11:56:41.782291,0,5089,3.0,10,0.1
2025-08-18T11:56:42.283046,0,5089,3.0,10,0.2
2025-08-18T11:56:42.783762,0,5089,3.0,10,0.2
2025-08-18T11:56:43.284350,0,5089,3.0,10,0.1
2025-08-18T11:56:43.784991,0,5089,3.0,10,0.1
2025-08-18T11:56:44.285619,0,5089,3.0,10,0.1
2025-08-18T11:56:44.786215,0,5089,3.0,10,1.7
2025-08-18T11:56:45.286776,0,5089,3.0,10,0.2
2025-08-18T11:56:45.787355,0,5089,3.0,10,0.6
2025-08-18T11:56:46.287988,0,5089,3.0,10,0.1
2025-08-18T11:56:46.788586,0,5089,3.0,10,0.4
2025-08-18T11:56:47.289237,0,5089,3.0,10,0.2
2025-08-18T11:56:47.789987,0,5089,3.0,10,0.2
2025-08-18T11:56:48.290697,0,5089,3.0,10,0.4
2025-08-18T11:56:48.791379,0,5089,3.0,10,0.1
2025-08-18T11:56:49.292052,0,5089,3.0,10,0.4
2025-08-18T11:56:49.792788,0,5089,3.0,10,0.3
2025-08-18T11:56:50.293493,0,5089,3.0,10,0.1
2025-08-18T11:56:50.794094,0,5089,3.0,10,0.1
2025-08-18T11:56:51.294915,0,5089,3.0,10,0.1
2025-08-18T11:56:51.796009,0,5089,3.0,10,0.1
2025-08-18T11:56:52.296804,0,5089,3.0,10,0.2
2025-08-18T11:56:52.797629,0,5089,3.0,10,0.1
2025-08-18T11:56:53.298437,0,5089,3.0,10,0.1
2025-08-18T11:56:53.799305,0,5089,3.0,10,0.2
2025-08-18T11:56:54.300124,0,5089,3.0,10,0.2
2025-08-18T11:56:54.800931,0,5089,3.0,10,0.1
2025-08-18T11:56:55.301791,0,5089,3.0,10,0.1
2025-08-18T11:56:55.802657,0,5089,3.0,10,0.2
2025-08-18T11:56:56.303423,0,5089,3.0,10,0.2
2025-08-18T11:56:56.804235,0,5089,3.0,10,0.2
2025-08-18T11:56:57.305040,0,5089,3.0,10,0.1
2025-08-18T11:56:57.805934,0,5089,3.0,10,0.1
2025-08-18T11:56:58.306770,0,5089,3.0,10,0.1
2025-08-18T11:56:58.807622,0,5089,3.0,10,0.1
2025-08-18T11:56:59.308387,0,5089,3.0,10,0.2
2025-08-18T11:56:59.809109,0,5089,3.0,10,0.8
2025-08-18T11:57:00.309884,0,5089,3.0,10,0.2
2025-08-18T11:57:00.810593,0,5089,3.0,10,0.1
2025-08-18T11:57:01.311294,0,5089,3.0,10,0.1
2025-08-18T11:57:01.811990,0,5089,3.0,10,0.2
2025-08-18T11:57:02.312816,0,5089,3.0,10,0.1
2025-08-18T11:57:02.813579,0,5089,3.0,10,0.3
2025-08-18T11:57:03.314215,0,5089,3.0,10,0.3
2025-08-18T11:57:03.814927,0,5089,3.0,10,0.2
2025-08-18T11:57:04.315679,0,5089,3.0,10,0.2
2025-08-18T11:57:04.816357,0,5089,3.0,10,0.2
2025-08-18T11:57:05.317050,0,5089,3.0,10,0.1
2025-08-18T11:57:05.817781,0,5089,3.0,10,0.1
2025-08-18T11:57:06.318540,0,5089,3.0,10,0.1
2025-08-18T11:57:06.819176,0,5089,3.0,10,0.1
2025-08-18T11:57:07.319961,0,5089,3.0,10,0.1
2025-08-18T11:57:07.820735,0,5089,3.0,10,0.1
2025-08-18T11:57:08.321475,0,5089,3.0,10,0.1
2025-08-18T11:57:08.822258,0,5089,3.0,10,0.1
2025-08-18T11:57:09.322968,0,5089,3.0,10,0.2
2025-08-18T11:57:09.823749,0,5089,3.0,10,0.2
2025-08-18T11:57:10.324441,0,5089,3.0,10,0.1
2025-08-18T11:57:10.825170,0,5089,3.0,10,0.2
2025-08-18T11:57:11.325983,0,5089,3.0,10,0.1
2025-08-18T11:57:11.826777,0,5089,3.0,10,0.1
2025-08-18T11:57:12.327532,0,5089,3.0,10,0.1
2025-08-18T11:57:12.828332,0,5089,3.0,10,0.1
2025-08-18T11:57:13.329071,0,5089,3.0,10,0.1
2025-08-18T11:57:13.829856,0,5089,3.0,10,0.0
2025-08-18T11:57:14.330692,0,5089,3.0,10,0.2
2025-08-18T11:57:14.831386,0,5089,3.0,10,0.4
2025-08-18T11:57:15.332166,0,5089,3.0,10,0.2
2025-08-18T11:57:15.832929,0,5089,3.0,10,0.6
2025-08-18T11:57:16.333491,0,5089,3.0,10,0.7
2025-08-18T11:57:16.833787,0,5089,3.0,10,3.3
2025-08-18T11:57:17.334055,0,5089,3.0,10,3.1
2025-08-18T11:57:17.834836,0,5089,3.0,10,0.9
2025-08-18T11:57:18.335611,0,5089,3.0,10,0.2
2025-08-18T11:57:18.836311,0,5089,3.0,10,0.2
2025-08-18T11:57:19.337049,0,5089,3.0,10,0.2
2025-08-18T11:57:19.837874,0,5089,3.0,10,0.2
2025-08-18T11:57:20.338610,0,5089,3.0,10,0.1
2025-08-18T11:57:20.839351,0,5089,3.0,10,0.1
2025-08-18T11:57:21.340095,0,5089,3.0,10,0.1
2025-08-18T11:57:21.840888,0,5089,3.0,10,0.1
2025-08-18T11:57:22.341698,0,5089,3.0,10,0.1
2025-08-18T11:57:22.842386,0,5089,3.0,10,0.1
2025-08-18T11:57:23.343145,0,5089,3.0,10,0.1
2025-08-18T11:57:23.843893,0,5089,3.0,10,0.1
2025-08-18T11:57:24.344701,0,5089,3.0,10,0.1
2025-08-18T11:57:24.845327,0,5089,3.0,10,0.1
2025-08-18T11:57:25.346134,0,5089,3.0,10,0.2
2025-08-18T11:57:25.846888,0,5089,3.0,10,0.2
2025-08-18T11:57:26.347651,0,5089,3.0,10,0.1
2025-08-18T11:57:26.848352,0,5089,3.0,10,0.2
2025-08-18T11:57:27.349055,0,5089,3.0,10,0.1
2025-08-18T11:57:27.849812,0,5089,3.0,10,0.1
2025-08-18T11:57:28.350610,0,5089,3.0,10,0.1
2025-08-18T11:57:28.851360,0,5089,3.0,10,0.2
2025-08-18T11:57:29.352011,0,5089,3.0,10,0.1
2025-08-18T11:57:29.852755,0,5089,3.0,10,0.2
2025-08-18T11:57:30.353489,0,5089,3.0,10,0.2
2025-08-18T11:57:30.854234,0,5089,3.0,10,0.1
2025-08-18T11:57:31.355011,0,5089,3.0,10,0.1
2025-08-18T11:57:31.855760,0,5089,3.0,10,0.1
2025-08-18T11:57:32.356550,0,5089,3.0,10,0.2
2025-08-18T11:57:32.857264,0,5089,3.0,10,0.2
2025-08-18T11:57:33.357994,0,5089,3.0,10,0.1
2025-08-18T11:57:33.858743,0,5089,3.0,10,0.1
2025-08-18T11:57:34.359471,0,5089,3.0,10,0.2
2025-08-18T11:57:34.860223,0,5089,3.0,10,0.1
2025-08-18T11:57:35.361008,0,5089,3.0,10,0.2
2025-08-18T11:57:35.861679,0,5089,3.0,10,0.1
2025-08-18T11:57:36.362383,0,5089,3.0,10,0.2
2025-08-18T11:57:36.863119,0,5089,3.0,10,0.1
2025-08-18T11:57:37.363873,0,5089,3.0,10,0.1
2025-08-18T11:57:37.864505,0,5089,3.0,10,0.1
2025-08-18T11:57:38.365157,0,5089,3.0,10,0.2
2025-08-18T11:57:38.865961,0,5089,3.0,10,0.2
2025-08-18T11:57:39.366547,0,5089,3.0,10,0.1
2025-08-18T11:57:39.867247,0,5089,3.0,10,0.2
2025-08-18T11:57:40.367942,0,5089,3.0,10,0.1
2025-08-18T11:57:40.868680,0,5089,3.0,10,0.1
2025-08-18T11:57:41.369350,0,5089,3.0,10,0.1
2025-08-18T11:57:41.870126,0,5089,3.0,10,0.1
2025-08-18T11:57:42.370885,0,5089,3.0,10,0.1
2025-08-18T11:57:42.871687,0,5089,3.0,10,0.1
2025-08-18T11:57:43.372365,0,5089,3.0,10,0.1
2025-08-18T11:57:43.873115,0,5089,3.0,10,0.2
2025-08-18T11:57:44.373907,0,5089,3.0,10,0.2
2025-08-18T11:57:44.874701,0,5089,3.0,10,0.5
2025-08-18T11:57:45.375380,0,5089,3.0,10,0.1
2025-08-18T11:57:45.876034,0,5089,3.0,10,0.7
2025-08-18T11:57:46.376783,0,5089,3.0,10,0.1
2025-08-18T11:57:46.877607,0,5089,3.0,10,0.4
2025-08-18T11:57:47.378352,0,5089,3.0,10,0.1
2025-08-18T11:57:47.879103,0,5089,3.0,10,0.3
2025-08-18T11:57:48.379862,0,5089,3.0,10,0.2
2025-08-18T11:57:48.880577,0,5089,3.0,10,0.3
2025-08-18T11:57:49.381244,0,5089,3.0,10,0.6
2025-08-18T11:57:49.881920,0,5089,3.0,10,0.1
2025-08-18T11:57:50.382627,0,5089,3.0,10,0.1
2025-08-18T11:57:50.883342,0,5089,3.0,10,0.1
2025-08-18T11:57:51.384048,0,5089,3.0,10,0.1
2025-08-18T11:57:51.884803,0,5089,3.0,10,0.1
2025-08-18T11:57:52.385482,0,5089,3.0,10,0.1
2025-08-18T11:57:52.886224,0,5089,3.0,10,0.2
2025-08-18T11:57:53.386944,0,5089,3.0,10,0.1
2025-08-18T11:57:53.887636,0,5089,3.0,10,0.1
2025-08-18T11:57:54.388341,0,5089,3.0,10,0.2
2025-08-18T11:57:54.889054,0,5089,3.0,10,0.2
2025-08-18T11:57:55.389761,0,5089,3.0,10,2.4
2025-08-18T11:57:55.890548,0,5089,3.0,10,0.1
2025-08-18T11:57:56.391270,0,5089,3.0,10,0.1
2025-08-18T11:57:56.891944,0,5089,3.0,10,0.1
2025-08-18T11:57:57.392677,0,5089,3.0,10,0.1
2025-08-18T11:57:57.893408,0,5089,3.0,10,0.2
2025-08-18T11:57:58.394130,0,5089,3.0,10,0.1
2025-08-18T11:57:58.894882,0,5089,3.0,10,0.1
2025-08-18T11:57:59.395647,0,5089,3.0,10,0.2
2025-08-18T11:57:59.896374,0,5089,3.0,10,0.8
2025-08-18T11:58:00.397066,0,5089,3.0,10,0.2
2025-08-18T11:58:00.897761,0,5089,3.0,10,0.1
2025-08-18T11:58:01.398357,0,5089,3.0,10,0.1
2025-08-18T11:58:01.899055,0,5089,3.0,10,0.1
2025-08-18T11:58:02.399694,0,5089,3.0,10,0.1
2025-08-18T11:58:02.900277,0,5089,3.0,10,0.1
2025-08-18T11:58:03.400962,0,5089,3.0,10,0.5
2025-08-18T11:58:03.901572,0,5089,3.0,10,0.2
2025-08-18T11:58:04.402169,0,5089,3.0,10,0.2
2025-08-18T11:58:04.902866,0,5089,3.0,10,0.2
2025-08-18T11:58:05.403620,0,5089,3.0,10,0.0
2025-08-18T11:58:05.904432,0,5089,3.0,10,0.1
2025-08-18T11:58:06.405112,0,5089,3.0,10,0.2
2025-08-18T11:58:06.905838,0,5089,3.0,10,0.1
2025-08-18T11:58:07.406650,0,5089,3.0,10,0.1
2025-08-18T11:58:07.907347,0,5089,3.0,10,0.1
2025-08-18T11:58:08.408085,0,5089,3.0,10,0.2
2025-08-18T11:58:08.908838,0,5089,3.0,10,0.1
2025-08-18T11:58:09.409596,0,5089,3.0,10,0.1
2025-08-18T11:58:09.910278,0,5089,3.0,10,0.2
2025-08-18T11:58:10.411016,0,5089,3.0,10,0.1
2025-08-18T11:58:10.911650,0,5089,3.0,10,0.1
2025-08-18T11:58:11.412248,0,5089,3.0,10,0.2
2025-08-18T11:58:11.912977,0,5089,3.0,10,0.1
2025-08-18T11:58:12.413579,0,5089,3.0,10,0.2
2025-08-18T11:58:12.914141,0,5089,3.0,10,0.2
2025-08-18T11:58:13.414837,0,5089,3.0,10,0.1
2025-08-18T11:58:13.915479,0,5089,3.0,10,0.1
2025-08-18T11:58:14.416155,0,5089,3.0,10,0.2
2025-08-18T11:58:14.916703,0,5089,3.0,10,0.4
2025-08-18T11:58:15.417335,0,5089,3.0,10,0.2
2025-08-18T11:58:15.917951,0,5089,3.0,10,0.8
2025-08-18T11:58:16.418604,0,5089,3.0,10,0.2
2025-08-18T11:58:16.919103,0,5089,3.0,10,0.3
2025-08-18T11:58:17.419688,0,5089,3.0,10,0.1
2025-08-18T11:58:17.920276,0,5089,3.0,10,0.3
2025-08-18T11:58:18.420897,0,5089,3.0,10,0.1
2025-08-18T11:58:18.921461,0,5089,3.0,10,0.2
2025-08-18T11:58:19.422093,0,5089,3.0,10,0.2
2025-08-18T11:58:19.922847,0,5089,3.0,10,0.3
2025-08-18T11:58:20.423582,0,5089,3.0,10,0.1
2025-08-18T11:58:20.924462,0,5089,3.0,10,0.2
2025-08-18T11:58:21.425334,0,5089,3.0,10,0.1
2025-08-18T11:58:21.926093,0,5089,3.0,10,0.1
2025-08-18T11:58:22.426913,0,5089,3.0,10,0.1
2025-08-18T11:58:22.927697,0,5089,3.0,10,0.1
2025-08-18T11:58:23.428475,0,5089,3.0,10,0.1
2025-08-18T11:58:23.929194,0,5089,3.0,10,0.2
2025-08-18T11:58:24.429977,0,5089,3.0,10,0.2
2025-08-18T11:58:24.930876,0,5089,3.0,10,0.1
2025-08-18T11:58:25.431727,0,5089,3.0,10,0.1
2025-08-18T11:58:25.932392,0,5089,3.0,10,0.1
2025-08-18T11:58:26.433162,0,5089,3.0,10,0.1
2025-08-18T11:58:26.933939,0,5089,3.0,10,0.1
2025-08-18T11:58:27.434735,0,5089,3.0,10,0.1
2025-08-18T11:58:27.935473,0,5089,3.0,10,0.1
2025-08-18T11:58:28.436117,0,5089,3.0,10,0.1
2025-08-18T11:58:28.936706,0,5089,3.0,10,0.1
2025-08-18T11:58:29.437503,0,5089,3.0,10,0.1
2025-08-18T11:58:29.938085,0,5089,3.0,10,0.2
2025-08-18T11:58:30.438864,0,5089,3.0,10,0.1
2025-08-18T11:58:30.939578,0,5089,3.0,10,0.1
2025-08-18T11:58:31.440318,0,5089,3.0,10,0.1
2025-08-18T11:58:31.941083,0,5089,3.0,10,0.1
2025-08-18T11:58:32.441689,0,5089,3.0,10,0.1
2025-08-18T11:58:32.942421,0,5089,3.0,10,0.2
2025-08-18T11:58:33.443100,0,5089,3.0,10,0.1
2025-08-18T11:58:33.943855,0,5089,3.0,10,0.1
2025-08-18T11:58:34.444462,0,5089,3.0,10,0.3
2025-08-18T11:58:34.945087,0,5089,3.0,10,0.1
2025-08-18T11:58:35.445813,0,5089,3.0,10,0.2
2025-08-18T11:58:35.946375,0,5089,3.0,10,0.1
2025-08-18T11:58:36.447173,0,5089,3.0,10,0.2
2025-08-18T11:58:36.947857,0,5089,3.0,10,0.1
2025-08-18T11:58:37.448454,0,5089,3.0,10,0.1
2025-08-18T11:58:37.949196,0,5089,3.0,10,0.1
2025-08-18T11:58:38.449944,0,5089,3.0,10,0.2
2025-08-18T11:58:38.950747,0,5089,3.0,10,0.1
2025-08-18T11:58:39.451501,0,5089,3.0,10,0.1
2025-08-18T11:58:39.952257,0,5089,3.0,10,0.3
2025-08-18T11:58:40.452964,0,5089,3.0,10,0.1
2025-08-18T11:58:40.953700,0,5089,3.0,10,0.2
2025-08-18T11:58:41.454414,0,5089,3.0,10,0.2
2025-08-18T11:58:41.955177,0,5089,3.0,10,0.1
2025-08-18T11:58:42.455953,0,5089,3.0,10,0.2
2025-08-18T11:58:42.956673,0,5089,3.0,10,0.2
2025-08-18T11:58:43.457355,0,5089,3.0,10,0.1
2025-08-18T11:58:43.958084,0,5089,3.0,10,0.2
2025-08-18T11:58:44.458874,0,5089,3.0,10,0.2
2025-08-18T11:58:44.959620,0,5089,3.0,10,0.4
2025-08-18T11:58:45.460329,0,5089,3.0,10,0.1
2025-08-18T11:58:45.960978,0,5089,3.0,10,0.8
2025-08-18T11:58:46.461694,0,5089,3.0,10,0.2
2025-08-18T11:58:46.962223,0,5089,3.0,10,0.4
2025-08-18T11:58:47.462912,0,5089,3.0,10,0.1
2025-08-18T11:58:47.963679,0,5089,3.0,10,0.5
2025-08-18T11:58:48.464289,0,5089,3.0,10,0.3
2025-08-18T11:58:48.964960,0,5089,3.0,10,0.4
2025-08-18T11:58:49.465736,0,5089,3.0,10,0.3
2025-08-18T11:58:49.966412,0,5089,3.0,10,0.2
2025-08-18T11:58:50.467168,0,5089,3.0,10,0.1
2025-08-18T11:58:50.967906,0,5089,3.0,10,0.1
2025-08-18T11:58:51.468610,0,5089,3.0,10,0.1
2025-08-18T11:58:51.969388,0,5089,3.0,10,0.1
2025-08-18T11:58:52.470083,0,5089,3.0,10,0.1
2025-08-18T11:58:52.970865,0,5089,3.0,10,0.1
2025-08-18T11:58:53.471589,0,5089,3.0,10,0.1
2025-08-18T11:58:53.972344,0,5089,3.0,10,0.2
2025-08-18T11:58:54.473078,0,5089,3.0,10,0.1
2025-08-18T11:58:54.973777,0,5089,3.0,10,0.1
2025-08-18T11:58:55.474076,0,5089,3.0,10,0.3
2025-08-18T11:58:55.974854,0,5089,3.0,10,0.2
2025-08-18T11:58:56.475696,0,5089,3.0,10,0.1
2025-08-18T11:58:56.976401,0,5089,3.0,10,0.2
2025-08-18T11:58:57.477037,0,5089,3.0,10,0.1
2025-08-18T11:58:57.977761,0,5089,3.0,10,0.2
2025-08-18T11:58:58.478343,0,5089,3.0,10,0.1
2025-08-18T11:58:58.979094,0,5089,3.0,10,0.1
2025-08-18T11:58:59.479894,0,5089,3.0,10,0.2
2025-08-18T11:58:59.980541,0,5089,3.0,10,0.7
2025-08-18T11:59:00.481117,0,5089,3.0,10,0.2
2025-08-18T11:59:00.981768,0,5089,3.0,10,1.8
2025-08-18T11:59:01.482370,0,5089,3.0,10,0.1
2025-08-18T11:59:01.983095,0,5089,3.0,10,0.1
2025-08-18T11:59:02.483908,0,5089,3.0,10,0.1
2025-08-18T11:59:02.984583,0,5089,3.0,10,0.1
2025-08-18T11:59:03.485279,0,5089,3.0,10,0.4
2025-08-18T11:59:03.985999,0,5089,3.0,10,0.1
2025-08-18T11:59:04.486740,0,5089,3.0,10,0.2
2025-08-18T11:59:04.987436,0,5089,3.0,10,0.2
2025-08-18T11:59:05.488173,0,5089,3.0,10,0.1
2025-08-18T11:59:05.988916,0,5089,3.0,10,0.2
2025-08-18T11:59:06.489715,0,5089,3.0,10,1.9
2025-08-18T11:59:06.990444,0,5089,3.0,10,0.1
2025-08-18T11:59:07.491176,0,5089,3.0,10,0.1
2025-08-18T11:59:07.991942,0,5089,3.0,10,0.1
2025-08-18T11:59:08.492700,0,5089,3.0,10,0.2
2025-08-18T11:59:08.993391,0,5089,3.0,10,0.2
2025-08-18T11:59:09.494099,0,5089,3.0,10,0.2
2025-08-18T11:59:09.994833,0,5089,3.0,10,0.2
2025-08-18T11:59:10.495493,0,5089,3.0,10,0.1
2025-08-18T11:59:10.996257,0,5089,3.0,10,0.2
2025-08-18T11:59:11.496986,0,5089,3.0,10,0.1
2025-08-18T11:59:11.997732,0,5089,3.0,10,0.1
2025-08-18T11:59:12.498337,0,5089,3.0,10,0.1
2025-08-18T11:59:12.999080,0,5089,3.0,10,0.2
2025-08-18T11:59:13.499703,0,5089,3.0,10,0.1
2025-08-18T11:59:14.000260,0,5089,3.0,10,0.1
2025-08-18T11:59:14.501004,0,5089,3.0,10,0.1
2025-08-18T11:59:15.001468,0,5089,3.0,10,0.3
2025-08-18T11:59:15.502141,0,5089,3.0,10,0.3
2025-08-18T11:59:16.002473,0,5089,3.0,10,3.3
2025-08-18T11:59:16.503378,0,5089,3.0,10,6.4
2025-08-18T11:59:17.004348,0,5089,3.0,10,0.9
2025-08-18T11:59:17.504784,0,5089,3.0,10,3.7
2025-08-18T11:59:18.005578,0,5089,3.0,10,5.6
2025-08-18T11:59:18.506404,0,5089,3.0,10,0.3
2025-08-18T11:59:19.006713,0,5089,3.0,10,2.9
2025-08-18T11:59:19.507024,0,5089,3.0,10,6.0
2025-08-18T11:59:20.007701,0,5089,3.0,10,0.8
2025-08-18T11:59:20.508274,0,5089,3.0,10,1.1
2025-08-18T11:59:21.009008,0,5089,3.0,10,0.9
2025-08-18T11:59:21.509870,0,5089,3.0,10,0.2
2025-08-18T11:59:22.010614,0,5089,3.0,10,0.3
2025-08-18T11:59:22.511227,0,5089,3.0,10,0.2
2025-08-18T11:59:23.011996,0,5089,3.0,10,0.1
2025-08-18T11:59:23.512657,0,5089,3.0,10,0.2
2025-08-18T11:59:24.013308,0,5089,3.0,10,0.1
2025-08-18T11:59:24.513926,0,5089,3.0,10,0.4
2025-08-18T11:59:25.014564,0,5089,3.0,10,0.1
2025-08-18T11:59:25.515191,0,5089,3.0,10,0.2
2025-08-18T11:59:26.015904,0,5089,3.0,10,0.3
2025-08-18T11:59:26.516590,0,5089,3.0,10,0.1
2025-08-18T11:59:27.017269,0,5089,3.0,10,0.1
2025-08-18T11:59:27.518020,0,5089,3.0,10,0.1
2025-08-18T11:59:28.018757,0,5089,3.0,10,0.2
2025-08-18T11:59:28.519387,0,5089,3.0,10,0.1
2025-08-18T11:59:29.020188,0,5089,3.0,10,0.2
2025-08-18T11:59:29.521022,0,5089,3.0,10,0.1
2025-08-18T11:59:30.021965,0,5089,3.0,10,0.1
2025-08-18T11:59:30.522770,0,5089,3.0,10,0.1
2025-08-18T11:59:31.023461,0,5089,3.0,10,0.1
2025-08-18T11:59:31.524299,0,5089,3.0,10,0.2
2025-08-18T11:59:32.025041,0,5089,3.0,10,0.1
2025-08-18T11:59:32.525857,0,5089,3.0,10,0.2
2025-08-18T11:59:33.026696,0,5089,3.0,10,0.1
2025-08-18T11:59:33.527448,0,5089,3.0,10,0.1
2025-08-18T11:59:34.028313,0,5089,3.0,10,0.1
2025-08-18T11:59:34.529177,0,5089,3.0,10,0.2
2025-08-18T11:59:35.030008,0,5089,3.0,10,0.1
2025-08-18T11:59:35.530885,0,5089,3.0,10,0.2
2025-08-18T11:59:36.031737,0,5089,3.0,10,0.1
2025-08-18T11:59:36.532653,0,5089,3.0,10,0.2
2025-08-18T11:59:37.033603,0,5089,3.0,10,0.2
2025-08-18T11:59:37.534415,0,5089,3.0,10,0.1
2025-08-18T11:59:38.035304,0,5089,3.0,10,0.1
2025-08-18T11:59:38.536223,0,5089,3.0,10,0.1
2025-08-18T11:59:39.037097,0,5089,3.0,10,0.2
2025-08-18T11:59:39.537823,0,5089,3.0,10,0.3
2025-08-18T11:59:40.038700,0,5089,3.0,10,0.2
2025-08-18T11:59:40.539477,0,5089,3.0,10,0.1
2025-08-18T11:59:41.040221,0,5089,3.0,10,0.1
2025-08-18T11:59:41.541049,0,5089,3.0,10,0.1
2025-08-18T11:59:42.041973,0,5089,3.0,10,0.2
2025-08-18T11:59:42.542868,0,5089,3.0,10,0.1
2025-08-18T11:59:43.043732,0,5089,3.0,10,0.1
2025-08-18T11:59:43.544378,0,5089,3.0,10,0.1
2025-08-18T11:59:44.045154,0,5089,3.0,10,0.2
2025-08-18T11:59:44.546004,0,5089,3.0,10,0.4
2025-08-18T11:59:45.046771,0,5089,3.0,10,0.2
2025-08-18T11:59:45.547551,0,5089,3.0,10,0.7
2025-08-18T11:59:46.048197,0,5089,3.0,10,1.1
2025-08-18T11:59:46.548943,0,5089,3.0,10,1.3
2025-08-18T11:59:47.049790,0,5089,3.0,10,0.1
2025-08-18T11:59:47.550582,0,5089,3.0,10,0.3
2025-08-18T11:59:48.051157,0,5089,3.0,10,2.6
2025-08-18T11:59:48.551893,0,5089,3.0,10,0.2
2025-08-18T11:59:49.052446,0,5089,3.0,10,0.3
2025-08-18T11:59:49.553203,0,5089,3.0,10,0.4
2025-08-18T11:59:50.053938,0,5089,3.0,10,0.1
2025-08-18T11:59:50.554732,0,5089,3.0,10,0.1
2025-08-18T11:59:51.055350,0,5089,3.0,10,0.2
2025-08-18T11:59:51.556040,0,5089,3.0,10,0.2
2025-08-18T11:59:52.056677,0,5089,3.0,10,0.0
2025-08-18T11:59:52.557620,0,5089,3.0,10,0.2
2025-08-18T11:59:53.058389,0,5089,3.0,10,0.1
2025-08-18T11:59:53.559137,0,5089,3.0,10,0.1
2025-08-18T11:59:54.059915,0,5089,3.0,10,0.1
2025-08-18T11:59:54.560744,0,5089,3.0,10,0.2
2025-08-18T11:59:55.061581,0,5089,3.0,10,0.1
2025-08-18T11:59:55.562353,0,5089,3.0,10,0.1
2025-08-18T11:59:56.063096,0,5089,3.0,10,0.1
2025-08-18T11:59:56.563860,0,5089,3.0,10,0.1
2025-08-18T11:59:57.064596,0,5089,3.0,10,0.1
2025-08-18T11:59:57.565171,0,5089,3.0,10,0.2
2025-08-18T11:59:58.065967,0,5089,3.0,10,0.1
2025-08-18T11:59:58.566735,0,5089,3.0,10,0.1
2025-08-18T11:59:59.067467,0,5089,3.0,10,0.2
2025-08-18T11:59:59.568182,0,5089,3.0,10,0.3
2025-08-18T12:00:00.068973,0,5089,3.0,10,0.8
2025-08-18T12:00:00.569796,0,5089,3.0,10,0.1
2025-08-18T12:00:01.070587,0,5089,3.0,10,0.2
2025-08-18T12:00:01.571354,0,5089,3.0,10,0.2
2025-08-18T12:00:02.072142,0,5089,3.0,10,0.1
2025-08-18T12:00:02.572979,0,5089,3.0,10,0.1
2025-08-18T12:00:03.073778,0,5089,3.0,10,0.1
2025-08-18T12:00:03.574554,0,5089,3.0,10,0.4
2025-08-18T12:00:04.075306,0,5089,3.0,10,0.2
2025-08-18T12:00:04.576039,0,5089,3.0,10,0.1
2025-08-18T12:00:05.076776,0,5089,3.0,10,0.1
2025-08-18T12:00:05.577537,0,5089,3.0,10,0.2
2025-08-18T12:00:06.078278,0,5089,3.0,10,0.1
2025-08-18T12:00:06.579094,0,5089,3.0,10,0.1
2025-08-18T12:00:07.079833,0,5089,3.0,10,0.1
2025-08-18T12:00:07.580602,0,5089,3.0,10,0.1
2025-08-18T12:00:08.081357,0,5089,3.0,10,0.2
2025-08-18T12:00:08.582084,0,5089,3.0,10,0.3
2025-08-18T12:00:09.082848,0,5089,3.0,10,0.2
2025-08-18T12:00:09.583572,0,5089,3.0,10,0.1
2025-08-18T12:00:10.084301,0,5089,3.0,10,0.2
2025-08-18T12:00:10.585092,0,5089,3.0,10,0.1
2025-08-18T12:00:11.085833,0,5089,3.0,10,0.1
2025-08-18T12:00:11.586585,0,5089,3.0,10,0.2
2025-08-18T12:00:12.087327,0,5089,3.0,10,0.2
2025-08-18T12:00:12.588083,0,5089,3.0,10,0.1
2025-08-18T12:00:13.088891,0,5089,3.0,10,0.1
2025-08-18T12:00:13.589712,0,5089,3.0,10,0.1
2025-08-18T12:00:14.090462,0,5089,3.0,10,0.2
2025-08-18T12:00:14.591262,0,5089,3.0,10,0.1
2025-08-18T12:00:15.092075,0,5089,3.0,10,0.2
2025-08-18T12:00:15.592710,0,5089,3.0,10,2.1
2025-08-18T12:00:16.093566,0,5089,3.0,10,0.2
2025-08-18T12:00:16.594129,0,5089,3.0,10,0.6
2025-08-18T12:00:17.094999,0,5089,3.0,10,0.2
2025-08-18T12:00:17.595626,0,5089,3.0,10,0.4
2025-08-18T12:00:18.096335,0,5089,3.0,10,0.2
2025-08-18T12:00:18.596988,0,5089,3.0,10,0.1
2025-08-18T12:00:19.097712,0,5089,3.0,10,0.1
2025-08-18T12:00:19.598313,0,5089,3.0,10,0.3
2025-08-18T12:00:20.098997,0,5089,3.0,10,0.1
2025-08-18T12:00:20.599722,0,5089,3.0,10,0.1
2025-08-18T12:00:21.100414,0,5089,3.0,10,0.1
2025-08-18T12:00:21.601005,0,5089,3.0,10,0.0
2025-08-18T12:00:22.101732,0,5089,3.0,10,0.1
2025-08-18T12:00:22.602430,0,5089,3.0,10,0.2
2025-08-18T12:00:23.103161,0,5089,3.0,10,0.0
2025-08-18T12:00:23.603887,0,5089,3.0,10,0.1
2025-08-18T12:00:24.104704,0,5089,3.0,10,0.2
2025-08-18T12:00:24.605417,0,5089,3.0,10,0.2
2025-08-18T12:00:25.106103,0,5089,3.0,10,0.1
2025-08-18T12:00:25.606807,0,5089,3.0,10,0.2
2025-08-18T12:00:26.107580,0,5089,3.0,10,0.1
2025-08-18T12:00:26.608240,0,5089,3.0,10,0.2
2025-08-18T12:00:27.109078,0,5089,3.0,10,0.1
2025-08-18T12:00:27.609745,0,5089,3.0,10,0.1
2025-08-18T12:00:28.110501,0,5089,3.0,10,0.1
2025-08-18T12:00:28.611338,0,5089,3.0,10,0.1
2025-08-18T12:00:29.112136,0,5089,3.0,10,0.1
2025-08-18T12:00:29.612963,0,5089,3.0,10,0.1
2025-08-18T12:00:30.113758,0,5089,3.0,10,2.1
2025-08-18T12:00:30.614483,0,5089,3.0,10,0.2
2025-08-18T12:00:31.115147,0,5089,3.0,10,0.1
2025-08-18T12:00:31.615935,0,5089,3.0,10,0.1
2025-08-18T12:00:32.116725,0,5089,3.0,10,0.1
2025-08-18T12:00:32.617401,0,5089,3.0,10,0.1
2025-08-18T12:00:33.118180,0,5089,3.0,10,0.2
2025-08-18T12:00:33.618892,0,5089,3.0,10,0.1
2025-08-18T12:00:34.119696,0,5089,3.0,10,0.1
2025-08-18T12:00:34.620388,0,5089,3.0,10,0.2
2025-08-18T12:00:35.121146,0,5089,3.0,10,0.1
2025-08-18T12:00:35.621949,0,5089,3.0,10,0.1
2025-08-18T12:00:36.122699,0,5089,3.0,10,0.1
2025-08-18T12:00:36.623456,0,5089,3.0,10,0.2
2025-08-18T12:00:37.124164,0,5089,3.0,10,0.2
2025-08-18T12:00:37.624905,0,5089,3.0,10,0.2
2025-08-18T12:00:38.125619,0,5089,3.0,10,0.1
2025-08-18T12:00:38.626378,0,5089,3.0,10,0.1
2025-08-18T12:00:39.127146,0,5089,3.0,10,0.1
2025-08-18T12:00:39.627879,0,5089,3.0,10,0.3
2025-08-18T12:00:40.128670,0,5089,3.0,10,0.1
2025-08-18T12:00:40.629426,0,5089,3.0,10,0.1
2025-08-18T12:00:41.130239,0,5089,3.0,10,0.1
2025-08-18T12:00:41.631060,0,5089,3.0,10,0.1
2025-08-18T12:00:42.131808,0,5089,3.0,10,0.1
2025-08-18T12:00:42.632491,0,5089,3.0,10,0.1
2025-08-18T12:00:43.133193,0,5089,3.0,10,0.1
2025-08-18T12:00:43.633871,0,5089,3.0,10,0.1
2025-08-18T12:00:44.134608,0,5089,3.0,10,0.1
2025-08-18T12:00:44.635306,0,5089,3.0,10,0.2
2025-08-18T12:00:45.136044,0,5089,3.0,10,0.1
2025-08-18T12:00:45.636835,0,5089,3.0,10,0.4
2025-08-18T12:00:46.137722,0,5089,3.0,10,0.1
2025-08-18T12:00:46.638442,0,5089,3.0,10,0.8
2025-08-18T12:00:47.139288,0,5089,3.0,10,0.1
2025-08-18T12:00:47.639998,0,5089,3.0,10,0.4
2025-08-18T12:00:48.140319,0,5089,3.0,10,1.8
2025-08-18T12:00:48.640936,0,5089,3.0,10,1.6
2025-08-18T12:00:49.141685,0,5089,3.0,10,0.4
2025-08-18T12:00:49.642334,0,5089,3.0,10,1.0
2025-08-18T12:00:50.143066,0,5089,3.0,10,0.1
2025-08-18T12:00:50.643787,0,5089,3.0,10,0.1
2025-08-18T12:00:51.144499,0,5089,3.0,10,0.3
2025-08-18T12:00:51.645254,0,5089,3.0,10,0.2
2025-08-18T12:00:52.146243,0,5089,3.0,10,0.1
2025-08-18T12:00:52.646926,0,5089,3.0,10,0.2
2025-08-18T12:00:53.147627,0,5089,3.0,10,0.5
2025-08-18T12:00:53.648330,0,5089,3.0,10,0.1
2025-08-18T12:00:54.149004,0,5089,3.0,10,0.2
2025-08-18T12:00:54.649722,0,5089,3.0,10,0.2
2025-08-18T12:00:55.150469,0,5089,3.0,10,0.2
2025-08-18T12:00:55.651219,0,5089,3.0,10,0.1
2025-08-18T12:00:56.151926,0,5089,3.0,10,0.1
2025-08-18T12:00:56.652670,0,5089,3.0,10,0.1
2025-08-18T12:00:57.153357,0,5089,3.0,10,0.1
2025-08-18T12:00:57.654057,0,5089,3.0,10,0.1
2025-08-18T12:00:58.154794,0,5089,3.0,10,2.5
2025-08-18T12:00:58.655382,0,5089,3.0,10,0.1
2025-08-18T12:00:59.156131,0,5089,3.0,10,0.2
2025-08-18T12:00:59.656925,0,5089,3.0,10,0.3
2025-08-18T12:01:00.157729,0,5089,3.0,10,0.6
2025-08-18T12:01:00.658457,0,5089,3.0,10,0.1
2025-08-18T12:01:01.159116,0,5089,3.0,10,0.2
2025-08-18T12:01:01.659893,0,5089,3.0,10,0.1
2025-08-18T12:01:02.160594,0,5089,3.0,10,0.2
2025-08-18T12:01:02.661344,0,5089,3.0,10,0.1
2025-08-18T12:01:03.161864,0,5089,3.0,10,0.4
2025-08-18T12:01:03.662591,0,5089,3.0,10,0.1
2025-08-18T12:01:04.163277,0,5089,3.0,10,0.3
2025-08-18T12:01:04.664045,0,5089,3.0,10,0.2
2025-08-18T12:01:05.164845,0,5089,3.0,10,0.1
2025-08-18T12:01:05.665600,0,5089,3.0,10,0.1
2025-08-18T12:01:06.166344,0,5089,3.0,10,0.1
2025-08-18T12:01:06.667049,0,5089,3.0,10,0.2
2025-08-18T12:01:07.167638,0,5089,3.0,10,0.1
2025-08-18T12:01:07.668343,0,5089,3.0,10,0.2
2025-08-18T12:01:08.169118,0,5089,3.0,10,0.1
2025-08-18T12:01:08.669870,0,5089,3.0,10,0.2
2025-08-18T12:01:09.170463,0,5089,3.0,10,0.1
2025-08-18T12:01:09.671066,0,5089,3.0,10,0.2
2025-08-18T12:01:10.171786,0,5089,3.0,10,0.1
2025-08-18T12:01:10.672371,0,5089,3.0,10,0.2
2025-08-18T12:01:11.173072,0,5089,3.0,10,0.1
2025-08-18T12:01:11.673799,0,5089,3.0,10,0.1
2025-08-18T12:01:12.174403,0,5089,3.0,10,0.1
2025-08-18T12:01:12.675037,0,5089,3.0,10,0.2
2025-08-18T12:01:13.175810,0,5089,3.0,10,0.1
2025-08-18T12:01:13.676423,0,5089,3.0,10,0.1
2025-08-18T12:01:14.177156,0,5089,3.0,10,0.1
2025-08-18T12:01:14.677757,0,5089,3.0,10,0.2
2025-08-18T12:01:15.178385,0,5089,3.0,10,0.1
2025-08-18T12:01:15.679055,0,5089,3.0,10,0.5
2025-08-18T12:01:16.179681,0,5089,3.0,10,0.2
2025-08-18T12:01:16.680265,0,5089,3.0,10,0.8
2025-08-18T12:01:17.181159,0,5089,3.0,10,0.2
2025-08-18T12:01:17.682023,0,5089,3.0,10,0.3
2025-08-18T12:01:18.182819,0,5089,3.0,10,0.2
2025-08-18T12:01:18.683641,0,5089,3.0,10,0.2
2025-08-18T12:01:19.184456,0,5089,3.0,10,0.2
2025-08-18T12:01:19.685196,0,5089,3.0,10,0.3
2025-08-18T12:01:20.185922,0,5089,3.0,10,0.2
2025-08-18T12:01:20.686664,0,5089,3.0,10,0.1
2025-08-18T12:01:21.187389,0,5089,3.0,10,0.1
2025-08-18T12:01:21.688141,0,5089,3.0,10,0.1
2025-08-18T12:01:22.188909,0,5089,3.0,10,0.1
2025-08-18T12:01:22.689776,0,5089,3.0,10,0.1
2025-08-18T12:01:23.190539,0,5089,3.0,10,0.1
2025-08-18T12:01:23.691217,0,5089,3.0,10,0.1
2025-08-18T12:01:24.192018,0,5089,3.0,10,0.1
2025-08-18T12:01:24.692825,0,5089,3.0,10,0.2
2025-08-18T12:01:25.193555,0,5089,3.0,10,0.1
2025-08-18T12:01:25.694326,0,5089,3.0,10,0.2
2025-08-18T12:01:26.195100,0,5089,3.0,10,0.1
2025-08-18T12:01:26.695836,0,5089,3.0,10,0.2
2025-08-18T12:01:27.196616,0,5089,3.0,10,0.1
2025-08-18T12:01:27.697354,0,5089,3.0,10,0.3
2025-08-18T12:01:28.198113,0,5089,3.0,10,0.1
2025-08-18T12:01:28.698967,0,5089,3.0,10,0.2
2025-08-18T12:01:29.199702,0,5089,3.0,10,0.1
2025-08-18T12:01:29.700430,0,5089,3.0,10,0.1
2025-08-18T12:01:30.201098,0,5089,3.0,10,0.2
2025-08-18T12:01:30.701815,0,5089,3.0,10,0.2
2025-08-18T12:01:31.202618,0,5089,3.0,10,0.1
2025-08-18T12:01:31.703323,0,5089,3.0,10,0.1
2025-08-18T12:01:32.204064,0,5089,3.0,10,0.1
2025-08-18T12:01:32.704744,0,5089,3.0,10,0.1
2025-08-18T12:01:33.205419,0,5089,3.0,10,0.1
2025-08-18T12:01:33.706216,0,5089,3.0,10,0.1
2025-08-18T12:01:34.206495,0,5089,3.0,10,5.6
2025-08-18T12:01:34.707123,0,5089,3.0,10,0.8
2025-08-18T12:01:35.207860,0,5089,3.0,10,0.2
2025-08-18T12:01:35.708158,0,5089,3.0,10,8.6
2025-08-18T12:01:36.208895,0,5089,3.0,10,2.1
2025-08-18T12:01:36.709171,0,5089,3.0,10,1.3
2025-08-18T12:01:37.209490,0,5089,3.0,10,3.9
2025-08-18T12:01:37.710379,0,5089,3.0,10,3.6
2025-08-18T12:01:38.211314,0,5089,3.0,10,0.6
2025-08-18T12:01:38.712246,0,5089,3.0,10,1.4
2025-08-18T12:01:39.213232,0,5089,3.0,10,0.5
2025-08-18T12:01:39.714237,0,5089,3.0,10,1.4
2025-08-18T12:01:40.215251,0,5089,3.0,10,0.2
2025-08-18T12:01:40.716237,0,5089,3.0,10,0.4
2025-08-18T12:01:41.217213,0,5089,3.0,10,0.6
2025-08-18T12:01:41.718214,0,5089,3.0,10,0.6
2025-08-18T12:01:42.219238,0,5089,3.0,10,0.6
2025-08-18T12:01:42.720220,0,5089,3.0,10,0.5
2025-08-18T12:01:43.220632,0,5089,3.0,10,5.4
2025-08-18T12:01:43.721143,0,5089,3.0,10,4.4
2025-08-18T12:01:44.221954,0,5089,3.0,10,4.1
2025-08-18T12:01:44.723011,0,5089,3.0,10,3.2
2025-08-18T12:01:45.224061,0,5089,3.0,10,0.2
2025-08-18T12:01:45.724981,0,5089,3.0,10,0.6
2025-08-18T12:01:46.225896,0,5089,3.0,10,0.5
2025-08-18T12:01:46.726850,0,5089,3.0,10,2.1
2025-08-18T12:01:47.227987,0,5089,3.0,10,0.7
2025-08-18T12:01:47.728584,0,5089,3.0,10,0.4
2025-08-18T12:01:48.229340,0,5089,3.0,10,0.2
2025-08-18T12:01:48.730093,0,5089,3.0,10,0.1
2025-08-18T12:01:49.230992,0,5089,3.0,10,0.5
2025-08-18T12:01:49.731696,0,5089,3.0,10,0.4
2025-08-18T12:01:50.232324,0,5089,3.0,10,0.2
2025-08-18T12:01:50.733058,0,5089,3.0,10,0.2
2025-08-18T12:01:51.233808,0,5089,3.0,10,0.2
2025-08-18T12:01:51.734433,0,5089,3.0,10,0.1
2025-08-18T12:01:52.235199,0,5089,3.0,10,0.1
2025-08-18T12:01:52.735943,0,5089,3.0,10,0.1
2025-08-18T12:01:53.236697,0,5089,3.0,10,0.2
2025-08-18T12:01:53.737388,0,5089,3.0,10,0.4
2025-08-18T12:01:54.238133,0,5089,3.0,10,0.2
2025-08-18T12:01:54.738963,0,5089,3.0,10,0.4
2025-08-18T12:01:55.239808,0,5089,3.0,10,0.1
2025-08-18T12:01:55.740577,0,5089,3.0,10,0.1
2025-08-18T12:01:56.241253,0,5089,3.0,10,0.1
2025-08-18T12:01:56.741961,0,5089,3.0,10,0.2
2025-08-18T12:01:57.242368,0,5089,3.0,10,5.7
2025-08-18T12:01:57.742927,0,5089,3.0,10,4.3
2025-08-18T12:01:58.243584,0,5089,3.0,10,2.9
2025-08-18T12:01:58.744217,0,5089,3.0,10,2.2
2025-08-18T12:01:59.244675,0,5089,3.0,10,3.8
2025-08-18T12:01:59.745177,0,5089,3.0,10,2.8
2025-08-18T12:02:00.245511,0,5089,3.0,10,4.6
2025-08-18T12:02:00.745785,0,5089,3.0,10,3.9
2025-08-18T12:02:01.246013,0,5089,3.0,10,3.9
2025-08-18T12:02:01.746294,0,5089,3.0,10,3.8
2025-08-18T12:02:02.246984,0,5089,3.0,10,0.2
2025-08-18T12:02:02.747617,0,5089,3.0,10,0.4
2025-08-18T12:02:03.247946,0,5089,3.0,10,6.3
2025-08-18T12:02:03.748550,0,5089,3.0,10,1.4
2025-08-18T12:02:04.249208,0,5089,3.0,10,0.6
2025-08-18T12:02:04.749897,0,5089,3.0,10,0.4
2025-08-18T12:02:05.250664,0,5089,3.0,10,0.1
2025-08-18T12:02:05.751457,0,5089,3.0,10,0.1
2025-08-18T12:02:06.252094,0,5089,3.0,10,0.2
2025-08-18T12:02:06.752860,0,5089,3.0,10,0.3
2025-08-18T12:02:07.253653,0,5089,3.0,10,0.1
2025-08-18T12:02:07.754365,0,5089,3.0,10,0.1
2025-08-18T12:02:08.255148,0,5089,3.0,10,0.2
2025-08-18T12:02:08.755915,0,5089,3.0,10,0.1
2025-08-18T12:02:09.256704,0,5089,3.0,10,0.1
2025-08-18T12:02:09.757278,0,5089,3.0,10,2.7
2025-08-18T12:02:10.257884,0,5089,3.0,10,6.1
2025-08-18T12:02:10.758378,0,5089,3.0,10,1.0
2025-08-18T12:02:11.258911,0,5089,3.0,10,3.0
2025-08-18T12:02:11.759259,0,5089,3.0,10,2.0
2025-08-18T12:02:12.259829,0,5089,3.0,10,2.8
2025-08-18T12:02:12.760285,0,5089,3.0,10,1.6
2025-08-18T12:02:13.260777,0,5089,3.0,10,3.0
2025-08-18T12:02:13.761819,0,5089,3.0,10,1.9
2025-08-18T12:02:14.262581,0,5089,3.0,10,2.0
2025-08-18T12:02:14.763109,0,5089,3.0,10,4.3
2025-08-18T12:02:15.263700,0,5089,3.0,10,1.9
2025-08-18T12:02:15.764180,0,5089,3.0,10,1.6
2025-08-18T12:02:16.264866,0,5089,3.0,10,2.1
2025-08-18T12:02:16.765537,0,5089,3.0,10,1.4
2025-08-18T12:02:17.266195,0,5089,3.0,10,4.7
2025-08-18T12:02:17.767002,0,5089,3.0,10,0.8
2025-08-18T12:02:18.267739,0,5089,3.0,10,1.9
2025-08-18T12:02:18.768283,0,5089,3.0,10,1.5
2025-08-18T12:02:19.268977,0,5089,3.0,10,0.5
2025-08-18T12:02:19.769938,0,5089,3.0,10,1.1
2025-08-18T12:02:20.270484,0,5089,3.0,10,0.4
2025-08-18T12:02:20.771035,0,5089,3.0,10,0.9
2025-08-18T12:02:21.271666,0,5089,3.0,10,0.9
2025-08-18T12:02:21.772292,0,5089,3.0,10,0.1
2025-08-18T12:02:22.273014,0,5089,3.0,10,0.1
2025-08-18T12:02:22.773678,0,5089,3.0,10,0.2
2025-08-18T12:02:23.274356,0,5089,3.0,10,0.1
2025-08-18T12:02:23.775081,0,5089,3.0,10,0.1
2025-08-18T12:02:24.275842,0,5089,3.0,10,0.1
2025-08-18T12:02:24.776614,0,5089,3.0,10,0.1
2025-08-18T12:02:25.277255,0,5089,3.0,10,1.9
2025-08-18T12:02:25.778006,0,5089,3.0,10,2.2
2025-08-18T12:02:26.278802,0,5089,3.0,10,0.1
2025-08-18T12:02:26.779553,0,5089,3.0,10,0.1
2025-08-18T12:02:27.280244,0,5089,3.0,10,0.2
2025-08-18T12:02:27.780982,0,5089,3.0,10,0.1
2025-08-18T12:02:28.281746,0,5089,3.0,10,0.1
2025-08-18T12:02:28.782502,0,5089,3.0,10,0.1
2025-08-18T12:02:29.283217,0,5089,3.0,10,0.2
2025-08-18T12:02:29.783945,0,5089,3.0,10,0.1
2025-08-18T12:02:30.284635,0,5089,3.0,10,0.1
2025-08-18T12:02:30.785361,0,5089,3.0,10,0.1
2025-08-18T12:02:31.286158,0,5089,3.0,10,0.2
2025-08-18T12:02:31.786958,0,5089,3.0,10,0.1
2025-08-18T12:02:32.287704,0,5089,3.0,10,0.2
2025-08-18T12:02:32.788404,0,5089,3.0,10,0.1
2025-08-18T12:02:33.289102,0,5089,3.0,10,0.1
2025-08-18T12:02:33.789844,0,5089,3.0,10,0.1
2025-08-18T12:02:34.290595,0,5089,3.0,10,0.1
2025-08-18T12:02:34.791282,0,5089,3.0,10,0.3
2025-08-18T12:02:35.292032,0,5089,3.0,10,0.1
2025-08-18T12:02:35.792759,0,5089,3.0,10,0.2
2025-08-18T12:02:36.293308,0,5089,3.0,10,2.4
2025-08-18T12:02:36.793894,0,5089,3.0,10,3.2
2025-08-18T12:02:37.294440,0,5089,3.0,10,0.6
2025-08-18T12:02:37.795294,0,5089,3.0,10,0.6
2025-08-18T12:02:38.295935,0,5089,3.0,10,1.2
2025-08-18T12:02:38.796594,0,5089,3.0,10,1.1
2025-08-18T12:02:39.297153,0,5089,3.0,10,0.4
2025-08-18T12:02:39.797908,0,5089,3.0,10,0.4
2025-08-18T12:02:40.298207,0,5089,3.0,10,3.4
2025-08-18T12:02:40.798485,0,5089,3.0,10,3.5
2025-08-18T12:02:41.298990,0,5089,3.0,10,1.1
2025-08-18T12:02:41.799763,0,5089,3.0,10,0.7
2025-08-18T12:02:42.300577,0,5089,3.0,10,0.1
2025-08-18T12:02:42.801222,0,5089,3.0,10,0.4
2025-08-18T12:02:43.301921,0,5089,3.0,10,0.3
2025-08-18T12:02:43.802736,0,5089,3.0,10,0.3
2025-08-18T12:02:44.303497,0,5089,3.0,10,0.2
2025-08-18T12:02:44.804238,0,5089,3.0,10,0.4
2025-08-18T12:02:45.304937,0,5089,3.0,10,0.3
2025-08-18T12:02:45.805606,0,5089,3.0,10,0.6
2025-08-18T12:02:46.306344,0,5089,3.0,10,0.9
2025-08-18T12:02:46.806946,0,5089,3.0,10,2.2
2025-08-18T12:02:47.307596,0,5089,3.0,10,1.8
2025-08-18T12:02:47.808228,0,5089,3.0,10,0.2
2025-08-18T12:02:48.309194,0,5089,3.0,10,0.4
2025-08-18T12:02:48.810035,0,5089,3.0,10,0.4
2025-08-18T12:02:49.310752,0,5089,3.0,10,1.5
2025-08-18T12:02:49.811491,0,5089,3.0,10,0.4
2025-08-18T12:02:50.312301,0,5089,3.0,10,0.2
2025-08-18T12:02:50.812999,0,5089,3.0,10,4.2
2025-08-18T12:02:51.313734,0,5089,3.0,10,1.9
2025-08-18T12:02:51.814204,0,5089,3.0,10,3.7
2025-08-18T12:02:52.314733,0,5089,3.0,10,5.2
2025-08-18T12:02:52.815429,0,5089,3.0,10,3.0
2025-08-18T12:02:53.316036,0,5089,3.0,10,3.4
2025-08-18T12:02:53.816713,0,5089,3.0,10,1.5
2025-08-18T12:02:54.317354,0,5089,3.0,10,2.1
2025-08-18T12:02:54.817913,0,5089,3.0,10,0.8
2025-08-18T12:02:55.318562,0,5089,3.0,10,1.8
2025-08-18T12:02:55.819206,0,5089,3.0,10,1.2
2025-08-18T12:02:56.319781,0,5089,3.0,10,3.2
2025-08-18T12:02:56.820323,0,5089,3.0,10,4.6
2025-08-18T12:02:57.320961,0,5089,3.0,10,1.7
2025-08-18T12:02:57.821498,0,5089,3.0,10,1.4
2025-08-18T12:02:58.322108,0,5089,3.0,10,1.6
2025-08-18T12:02:58.822695,0,5089,3.0,10,1.0
2025-08-18T12:02:59.323248,0,5089,3.0,10,1.4
2025-08-18T12:02:59.823844,0,5089,3.0,10,1.3
2025-08-18T12:03:00.324401,0,5089,3.0,10,1.7
2025-08-18T12:03:00.824980,0,5089,3.0,10,0.9
2025-08-18T12:03:01.325770,0,5089,3.0,10,0.4
2025-08-18T12:03:01.826386,0,5089,3.0,10,0.2
2025-08-18T12:03:02.326928,0,5089,3.0,10,1.2
2025-08-18T12:03:02.827476,0,5089,3.0,10,1.4
2025-08-18T12:03:03.328037,0,5089,3.0,10,2.1
2025-08-18T12:03:03.828336,0,5089,3.0,10,4.2
2025-08-18T12:03:04.328894,0,5089,3.0,10,1.2
2025-08-18T12:03:04.829433,0,5089,3.0,10,0.7
2025-08-18T12:03:05.330024,0,5089,3.0,10,0.4
2025-08-18T12:03:05.830580,0,5089,3.0,10,2.6
2025-08-18T12:03:06.331126,0,5089,3.0,10,2.6
2025-08-18T12:03:06.831807,0,5089,3.0,10,0.6
2025-08-18T12:03:07.332498,0,5089,3.0,10,0.4
2025-08-18T12:03:07.833153,0,5089,3.0,10,0.4
2025-08-18T12:03:08.333933,0,5089,3.0,10,0.2
2025-08-18T12:03:08.834699,0,5089,3.0,10,0.4
2025-08-18T12:03:09.335452,0,5089,3.0,10,0.2
2025-08-18T12:03:09.836252,0,5089,3.0,10,0.3
2025-08-18T12:03:10.336990,0,5089,3.0,10,0.6
2025-08-18T12:03:10.837767,0,5089,3.0,10,0.6
2025-08-18T12:03:11.338485,0,5089,3.0,10,0.4
2025-08-18T12:03:11.839247,0,5089,3.0,10,0.2
2025-08-18T12:03:12.340030,0,5089,3.0,10,0.3
2025-08-18T12:03:12.840691,0,5089,3.0,10,0.5
2025-08-18T12:03:13.341346,0,5089,3.0,10,0.5
2025-08-18T12:03:13.842024,0,5089,3.0,10,0.6
2025-08-18T12:03:14.342737,0,5089,3.0,10,0.2
2025-08-18T12:03:14.843543,0,5089,3.0,10,0.3
2025-08-18T12:03:15.344329,0,5089,3.0,10,0.1
2025-08-18T12:03:15.845107,0,5089,3.0,10,0.1
2025-08-18T12:03:16.345836,0,5089,3.0,10,1.2
2025-08-18T12:03:16.846464,0,5089,3.0,10,1.0
2025-08-18T12:03:17.347020,0,5089,3.0,10,2.1
2025-08-18T12:03:17.847697,0,5089,3.0,10,0.6
2025-08-18T12:03:18.348324,0,5089,3.0,10,0.4
2025-08-18T12:03:18.849085,0,5089,3.0,10,0.5
2025-08-18T12:03:19.349885,0,5089,3.0,10,0.3
2025-08-18T12:03:19.850672,0,5089,3.0,10,0.4
2025-08-18T12:03:20.351365,0,5089,3.0,10,0.5
2025-08-18T12:03:20.852161,0,5089,3.0,10,0.4
2025-08-18T12:03:21.352616,0,5089,3.0,10,19.5
2025-08-18T12:03:21.853711,0,5089,3.0,10,4.7
2025-08-18T12:03:22.354109,0,5089,3.0,10,19.0
2025-08-18T12:03:22.854681,0,5089,3.0,10,1.3
2025-08-18T12:03:23.354947,0,5089,3.0,10,8.4
2025-08-18T12:03:23.855269,0,5089,3.0,10,4.6
2025-08-18T12:03:24.355611,0,5089,3.0,10,7.4
2025-08-18T12:03:24.855883,0,5089,3.0,10,5.1
2025-08-18T12:03:25.356138,0,5089,3.0,10,5.2
2025-08-18T12:03:25.856364,0,5089,3.0,10,3.4
2025-08-18T12:03:26.356726,0,5089,3.0,10,3.6
2025-08-18T12:03:26.857078,0,5089,3.0,10,3.7
2025-08-18T12:03:27.357365,0,5089,3.0,10,4.1
2025-08-18T12:03:27.857706,0,5089,3.0,10,3.7
2025-08-18T12:03:28.357936,0,5089,3.0,10,3.9
2025-08-18T12:03:28.858181,0,5089,3.0,10,3.8
2025-08-18T12:03:29.358446,0,5089,3.0,10,5.3
2025-08-18T12:03:29.858698,0,5089,3.0,10,3.6
2025-08-18T12:03:30.358923,0,5089,3.0,10,3.3
2025-08-18T12:03:30.859143,0,5089,3.0,10,3.4
2025-08-18T12:03:31.359372,0,5089,3.0,10,3.1
2025-08-18T12:03:31.859626,0,5089,3.0,10,3.1
2025-08-18T12:03:32.359842,0,5089,3.0,10,3.1
2025-08-18T12:03:32.860077,0,5089,3.0,10,3.6
2025-08-18T12:03:33.360374,0,5089,3.0,10,4.1
2025-08-18T12:03:33.860632,0,5089,3.0,10,3.5
2025-08-18T12:03:34.360848,0,5089,3.0,10,2.9
2025-08-18T12:03:34.861058,0,5089,3.0,10,3.6
2025-08-18T12:03:35.361296,0,5089,3.0,10,3.1
2025-08-18T12:03:35.861552,0,5089,3.0,10,4.0
2025-08-18T12:03:36.361848,0,5089,3.0,10,8.0
2025-08-18T12:03:36.862072,0,5089,3.0,10,4.4
2025-08-18T12:03:37.362294,0,5089,3.0,10,5.1
2025-08-18T12:03:37.862798,0,5089,3.0,10,3.8
2025-08-18T12:03:38.363096,0,5089,3.0,10,6.0
2025-08-18T12:03:38.863471,0,5089,3.0,10,6.4
2025-08-18T12:03:39.364004,0,5089,3.0,10,3.6
2025-08-18T12:03:39.864602,0,5089,3.0,10,3.0
2025-08-18T12:03:40.365206,0,5089,3.0,10,3.6
2025-08-18T12:03:40.865789,0,5089,3.0,10,0.8
2025-08-18T12:03:41.366317,0,5089,3.0,10,5.2
2025-08-18T12:03:41.866963,0,5089,3.0,10,3.8
2025-08-18T12:03:42.367319,0,5089,3.0,10,5.7
2025-08-18T12:03:42.867637,0,5089,3.0,10,10.9
2025-08-18T12:03:43.367920,0,5089,3.0,10,8.7
2025-08-18T12:03:43.868221,0,5089,3.0,10,9.7
2025-08-18T12:03:44.368557,0,5089,3.0,10,11.3
2025-08-18T12:03:44.869213,0,5089,3.0,10,6.2
2025-08-18T12:03:45.369691,0,5089,3.0,10,5.5
2025-08-18T12:03:45.870008,0,5089,3.0,10,3.7
2025-08-18T12:03:46.370535,0,5089,3.0,10,5.4
2025-08-18T12:03:46.870895,0,5089,3.0,10,4.4
2025-08-18T12:03:47.371390,0,5089,3.0,10,5.3
2025-08-18T12:03:47.871727,0,5089,3.0,10,4.9
2025-08-18T12:03:48.371981,0,5089,3.0,10,3.3
2025-08-18T12:03:48.872501,0,5089,3.0,10,1.8
2025-08-18T12:03:49.373157,0,5089,3.0,10,1.6
2025-08-18T12:03:49.873558,0,5089,3.0,10,3.3
2025-08-18T12:03:50.374210,0,5089,3.0,10,2.1
2025-08-18T12:03:50.874944,0,5089,3.0,10,0.8
2025-08-18T12:03:51.375332,0,5089,3.0,10,0.3
2025-08-18T12:03:51.875789,0,5089,3.0,10,3.4
2025-08-18T12:03:52.376306,0,5089,3.0,10,1.2
2025-08-18T12:03:52.876878,0,5089,3.0,10,2.3
2025-08-18T12:03:53.377645,0,5089,3.0,10,0.4
2025-08-18T12:03:53.878285,0,5089,3.0,10,0.7
2025-08-18T12:03:54.379003,0,5089,3.0,10,0.4
2025-08-18T12:03:54.879765,0,5089,3.0,10,0.3
2025-08-18T12:03:55.380440,0,5089,3.0,10,2.1
2025-08-18T12:03:55.881236,0,5089,3.0,10,3.5
2025-08-18T12:03:56.381970,0,5089,3.0,10,0.6
2025-08-18T12:03:56.882896,0,5089,3.0,10,0.3
2025-08-18T12:03:57.383504,0,5089,3.0,10,0.2
2025-08-18T12:03:57.884083,0,5089,3.0,10,0.7
2025-08-18T12:03:58.384405,0,5089,3.0,10,1.7
2025-08-18T12:03:58.885097,0,5089,3.0,10,1.5
2025-08-18T12:03:59.385886,0,5089,3.0,10,0.3
2025-08-18T12:03:59.886406,0,5089,3.0,10,2.4
2025-08-18T12:04:00.386942,0,5089,3.0,10,2.8
2025-08-18T12:04:00.887254,0,5089,3.0,10,3.2
2025-08-18T12:04:01.387593,0,5089,3.0,10,4.3
2025-08-18T12:04:01.888331,0,5089,3.0,10,2.7
2025-08-18T12:04:02.389190,0,5089,3.0,10,3.6
2025-08-18T12:04:02.890219,0,5089,3.0,10,2.6
2025-08-18T12:04:03.391150,0,5089,3.0,10,0.7
2025-08-18T12:04:03.892176,0,5089,3.0,10,0.3
2025-08-18T12:04:04.392903,0,5089,3.0,10,1.4
2025-08-18T12:04:04.893590,0,5089,3.0,10,0.7
2025-08-18T12:04:05.393915,0,5089,3.0,10,4.5
2025-08-18T12:04:05.894575,0,5089,3.0,10,1.3
2025-08-18T12:04:06.395263,0,5089,3.0,10,2.1
2025-08-18T12:04:06.895629,0,5089,3.0,10,2.8
2025-08-18T12:04:07.395909,0,5089,3.0,10,2.9
2025-08-18T12:04:07.896482,0,5089,3.0,10,0.8
2025-08-18T12:04:08.397215,0,5089,3.0,10,0.8
2025-08-18T12:04:08.898051,0,5089,3.0,10,0.2
2025-08-18T12:04:09.398438,0,5089,3.0,10,3.2
2025-08-18T12:04:09.899180,0,5089,3.0,10,0.3
2025-08-18T12:04:10.400125,0,5089,3.0,10,0.1
2025-08-18T12:04:10.900758,0,5089,3.0,10,1.1
2025-08-18T12:04:11.401547,0,5089,3.0,10,0.1
2025-08-18T12:04:11.902169,0,5089,3.0,10,0.2
2025-08-18T12:04:12.402999,0,5089,3.0,10,0.2
2025-08-18T12:04:12.903409,0,5089,3.0,10,1.9
2025-08-18T12:04:13.404062,0,5089,3.0,10,0.7
2025-08-18T12:04:13.904841,0,5089,3.0,10,0.2
2025-08-18T12:04:14.405650,0,5089,3.0,10,0.2
2025-08-18T12:04:14.906464,0,5089,3.0,10,0.3
2025-08-18T12:04:15.407305,0,5089,3.0,10,0.2
2025-08-18T12:04:15.908051,0,5089,3.0,10,0.1
2025-08-18T12:04:16.408821,0,5089,3.0,10,0.7
2025-08-18T12:04:16.909447,0,5089,3.0,10,1.1
2025-08-18T12:04:17.409979,0,5089,3.0,10,1.9
2025-08-18T12:04:17.910786,0,5089,3.0,10,0.8
2025-08-18T12:04:18.411442,0,5089,3.0,10,0.4
2025-08-18T12:04:18.912217,0,5089,3.0,10,0.4
2025-08-18T12:04:19.412985,0,5089,3.0,10,0.2
2025-08-18T12:04:19.913775,0,5089,3.0,10,0.2
2025-08-18T12:04:20.414617,0,5089,3.0,10,0.2
2025-08-18T12:04:20.915348,0,5089,3.0,10,0.1
2025-08-18T12:04:21.416108,0,5089,3.0,10,0.3
2025-08-18T12:04:21.916863,0,5089,3.0,10,0.9
2025-08-18T12:04:22.417600,0,5089,3.0,10,0.1
2025-08-18T12:04:22.918199,0,5089,3.0,10,0.3
2025-08-18T12:04:23.418994,0,5089,3.0,10,0.2
2025-08-18T12:04:23.919781,0,5089,3.0,10,0.2
2025-08-18T12:04:24.420454,0,5089,3.0,10,0.2
2025-08-18T12:04:24.921187,0,5089,3.0,10,0.1
2025-08-18T12:04:25.421925,0,5089,3.0,10,0.2
2025-08-18T12:04:25.922679,0,5089,3.0,10,0.1
2025-08-18T12:04:26.423405,0,5089,3.0,10,0.1
2025-08-18T12:04:26.924135,0,5089,3.0,10,0.1
2025-08-18T12:04:27.424872,0,5089,3.0,10,0.2
2025-08-18T12:04:27.925606,0,5089,3.0,10,0.2
2025-08-18T12:04:28.426325,0,5089,3.0,10,1.1
2025-08-18T12:04:28.927024,0,5089,3.0,10,0.1
2025-08-18T12:04:29.427773,0,5089,3.0,10,0.2
2025-08-18T12:04:29.928495,0,5089,3.0,10,0.2
2025-08-18T12:04:30.428937,0,5089,3.0,10,2.6
2025-08-18T12:04:30.929606,0,5089,3.0,10,4.5
2025-08-18T12:04:31.430204,0,5089,3.0,10,3.9
2025-08-18T12:04:31.930664,0,5089,3.0,10,6.2
2025-08-18T12:04:32.431319,0,5089,3.0,10,5.3
2025-08-18T12:04:32.931901,0,5089,3.0,10,5.1
2025-08-18T12:04:33.432464,0,5089,3.0,10,4.0
2025-08-18T12:04:33.933021,0,5089,3.0,10,3.0
2025-08-18T12:04:34.433296,0,5089,3.0,10,7.8
2025-08-18T12:04:34.933684,0,5089,3.0,10,5.1
2025-08-18T12:04:35.434485,0,5089,3.0,10,8.3
2025-08-18T12:04:35.934802,0,5089,3.0,10,2.8
2025-08-18T12:04:36.435210,0,5089,3.0,10,7.2
2025-08-18T12:04:36.936094,0,5089,3.0,10,0.8
2025-08-18T12:04:37.436815,0,5089,3.0,10,3.3
2025-08-18T12:04:37.937617,0,5089,3.0,10,1.7
2025-08-18T12:04:38.438322,0,5089,3.0,10,2.7
2025-08-18T12:04:38.939061,0,5089,3.0,10,2.6
2025-08-18T12:04:39.439422,0,5089,3.0,10,2.8
2025-08-18T12:04:39.939957,0,5089,3.0,10,1.3
2025-08-18T12:04:40.440506,0,5089,3.0,10,0.7
2025-08-18T12:04:40.940857,0,5089,3.0,10,1.3
2025-08-18T12:04:41.441326,0,5089,3.0,10,0.6
2025-08-18T12:04:41.942006,0,5089,3.0,10,2.1
2025-08-18T12:04:42.442734,0,5089,3.0,10,0.2
2025-08-18T12:04:42.943323,0,5089,3.0,10,0.5
2025-08-18T12:04:43.443989,0,5089,3.0,10,0.2
2025-08-18T12:04:43.944713,0,5089,3.0,10,0.4
2025-08-18T12:04:44.445343,0,5089,3.0,10,0.2
2025-08-18T12:04:44.946280,0,5089,3.0,10,0.2
2025-08-18T12:04:45.446989,0,5089,3.0,10,0.2
2025-08-18T12:04:45.947736,0,5089,3.0,10,0.1
2025-08-18T12:04:46.448505,0,5089,3.0,10,0.3
2025-08-18T12:04:46.949008,0,5089,3.0,10,1.3
2025-08-18T12:04:47.449607,0,5089,3.0,10,2.0
2025-08-18T12:04:47.950216,0,5089,3.0,10,2.4
2025-08-18T12:04:48.450805,0,5089,3.0,10,1.3
2025-08-18T12:04:48.951390,0,5089,3.0,10,0.8
2025-08-18T12:04:49.451962,0,5089,3.0,10,0.9
2025-08-18T12:04:49.952813,0,5089,3.0,10,0.8
2025-08-18T12:04:50.453394,0,5089,3.0,10,1.1
2025-08-18T12:04:50.953955,0,5089,3.0,10,0.8
2025-08-18T12:04:51.454703,0,5089,3.0,10,0.8
2025-08-18T12:04:51.955253,0,5089,3.0,10,0.8
2025-08-18T12:04:52.455848,0,5089,3.0,10,1.1
2025-08-18T12:04:52.956551,0,5089,3.0,10,1.1
2025-08-18T12:04:53.457271,0,5089,3.0,10,0.3
2025-08-18T12:04:53.957962,0,5089,3.0,10,0.2
2025-08-18T12:04:54.458961,0,5089,3.0,10,0.8
2025-08-18T12:04:54.959577,0,5089,3.0,10,1.2
2025-08-18T12:04:55.460169,0,5089,3.0,10,2.0
2025-08-18T12:04:55.960770,0,5089,3.0,10,0.9
2025-08-18T12:04:56.461574,0,5089,3.0,10,0.8
2025-08-18T12:04:56.962368,0,5089,3.0,10,0.9
2025-08-18T12:04:57.463396,0,5089,3.0,10,0.4
2025-08-18T12:04:57.964434,0,5089,3.0,10,0.4
2025-08-18T12:04:58.465405,0,5089,3.0,10,0.3
2025-08-18T12:04:58.966367,0,5089,3.0,10,1.1
2025-08-18T12:04:59.467089,0,5089,3.0,10,6.4
2025-08-18T12:04:59.967431,0,5089,3.0,10,7.3
2025-08-18T12:05:00.468194,0,5089,3.0,10,3.3
2025-08-18T12:05:00.969080,0,5089,3.0,10,1.5
2025-08-18T12:05:01.469974,0,5089,3.0,10,1.1
2025-08-18T12:05:01.970902,0,5089,3.0,10,2.1
2025-08-18T12:05:02.471805,0,5089,3.0,10,3.7
2025-08-18T12:05:02.973132,0,5089,3.0,10,0.5
2025-08-18T12:05:03.473991,0,5089,3.0,10,0.6
2025-08-18T12:05:03.974655,0,5089,3.0,10,0.4
2025-08-18T12:05:04.475307,0,5089,3.0,10,1.1
2025-08-18T12:05:04.975918,0,5089,3.0,10,2.8
2025-08-18T12:05:05.476612,0,5089,3.0,10,5.4
2025-08-18T12:05:05.976982,0,5089,3.0,10,3.9
2025-08-18T12:05:06.477549,0,5089,3.0,10,4.6
2025-08-18T12:05:06.978201,0,5089,3.0,10,1.2
2025-08-18T12:05:07.478898,0,5089,3.0,10,1.5
2025-08-18T12:05:07.979650,0,5089,3.0,10,1.4
2025-08-18T12:05:08.480408,0,5089,3.0,10,0.3
2025-08-18T12:05:08.981123,0,5089,3.0,10,0.7
2025-08-18T12:05:09.481818,0,5089,3.0,10,1.0
2025-08-18T12:05:09.982395,0,5089,3.0,10,3.1
2025-08-18T12:05:10.483041,0,5089,3.0,10,3.4
2025-08-18T12:05:10.983637,0,5089,3.0,10,2.1
2025-08-18T12:05:11.484208,0,5089,3.0,10,1.4
2025-08-18T12:05:11.984996,0,5089,3.0,10,2.3
2025-08-18T12:05:12.485599,0,5089,3.0,10,2.4
2025-08-18T12:05:12.986190,0,5089,3.0,10,2.1
2025-08-18T12:05:13.487028,0,5089,3.0,10,1.8
2025-08-18T12:05:13.987648,0,5089,3.0,10,3.3
2025-08-18T12:05:14.488220,0,5089,3.0,10,2.2
2025-08-18T12:05:14.988835,0,5089,3.0,10,2.1
2025-08-18T12:05:15.489356,0,5089,3.0,10,2.4
2025-08-18T12:05:15.989979,0,5089,3.0,10,3.3
2025-08-18T12:05:16.490574,0,5089,3.0,10,2.7
2025-08-18T12:05:16.991328,0,5089,3.0,10,1.1
2025-08-18T12:05:17.491870,0,5089,3.0,10,1.0
2025-08-18T12:05:17.992499,0,5089,3.0,10,1.6
2025-08-18T12:05:18.493267,0,5089,3.0,10,0.3
2025-08-18T12:05:18.994035,0,5089,3.0,10,0.3
2025-08-18T12:05:19.494791,0,5089,3.0,10,0.4
2025-08-18T12:05:19.995555,0,5089,3.0,10,0.3
2025-08-18T12:05:20.496297,0,5089,3.0,10,0.3
2025-08-18T12:05:20.997179,0,5089,3.0,10,0.1
2025-08-18T12:05:21.497988,0,5089,3.0,10,0.1
2025-08-18T12:05:21.998712,0,5089,3.0,10,0.2
2025-08-18T12:05:22.499459,0,5089,3.0,10,0.1
2025-08-18T12:05:23.000132,0,5089,3.0,10,1.6
2025-08-18T12:05:23.500718,0,5089,3.0,10,0.6
2025-08-18T12:05:24.001377,0,5089,3.0,10,1.1
2025-08-18T12:05:24.501956,0,5089,3.0,10,0.8
2025-08-18T12:05:25.002468,0,5089,3.0,10,1.2
2025-08-18T12:05:25.502904,0,5089,3.0,10,3.7
2025-08-18T12:05:26.003471,0,5089,3.0,10,5.1
2025-08-18T12:05:26.504145,0,5089,3.0,10,4.7
2025-08-18T12:05:27.004448,0,5089,3.0,10,2.4
2025-08-18T12:05:27.504937,0,5089,3.0,10,3.7
2025-08-18T12:05:28.005561,0,5089,3.0,10,1.2
2025-08-18T12:05:28.506257,0,5089,3.0,10,1.0
2025-08-18T12:05:29.006875,0,5089,3.0,10,2.5
2025-08-18T12:05:29.507492,0,5089,3.0,10,2.7
2025-08-18T12:05:30.007913,0,5089,3.0,10,6.9
2025-08-18T12:05:30.508503,0,5089,3.0,10,1.8
2025-08-18T12:05:31.009060,0,5089,3.0,10,1.7
2025-08-18T12:05:31.509544,0,5089,3.0,10,5.1
