timestamp,interval_count,total_count,queue_size,max_queue_size,cpu_percent
2025-08-26T11:27:47.344931,180,180,3.0944444444444446,10,0.0
2025-08-26T11:27:47.845339,147,327,4.489795918367347,10,7.2
2025-08-26T11:27:48.345924,95,422,3.789473684210526,10,5.6
2025-08-26T11:27:48.846268,99,521,4.121212121212121,10,5.5
2025-08-26T11:27:49.346611,34,555,4.029411764705882,10,5.1
2025-08-26T11:27:49.846935,129,684,3.705426356589147,10,6.0
2025-08-26T11:27:50.347291,107,791,3.850467289719626,10,7.4
2025-08-26T11:27:50.847616,75,866,4.8,10,5.4
2025-08-26T11:27:51.347999,93,959,3.4516129032258065,10,5.8
2025-08-26T11:27:51.848729,24,983,3.3125,10,5.7
2025-08-26T11:27:52.349081,48,1031,2.3035714285714284,10,5.3
2025-08-26T11:27:52.849367,40,1071,5.275,10,6.9
2025-08-26T11:27:53.349659,5,1076,3.0,10,8.0
2025-08-26T11:27:53.849911,10,1086,1.6,10,4.5
2025-08-26T11:27:54.350233,48,1134,2.8125,10,5.3
2025-08-26T11:27:54.850455,83,1217,4.0,10,7.3
2025-08-26T11:27:55.350726,65,1282,3.3846153846153846,10,6.9
2025-08-26T11:27:55.851007,0,1282,7.0,10,3.8
2025-08-26T11:27:56.351318,49,1331,4.510204081632653,10,4.8
2025-08-26T11:27:56.851597,10,1341,2.5,10,4.0
2025-08-26T11:27:57.351896,13,1354,4.0,10,5.4
2025-08-26T11:27:57.852166,10,1364,4.6,10,3.8
2025-08-26T11:27:58.352467,0,1364,9.0,10,4.9
2025-08-26T11:27:58.852756,0,1364,9.0,10,4.1
2025-08-26T11:27:59.353047,3,1367,1.3333333333333333,10,4.5
2025-08-26T11:27:59.853331,10,1377,1.3,10,6.0
2025-08-26T11:28:00.353622,0,1377,3.0,10,4.1
2025-08-26T11:28:00.853830,0,1377,3.0,10,4.1
2025-08-26T11:28:01.354106,0,1377,3.0,10,3.8
2025-08-26T11:28:01.854317,0,1377,3.0,10,6.3
2025-08-26T11:28:02.354554,0,1377,3.0,10,3.9
2025-08-26T11:28:02.854794,0,1377,3.0,10,3.6
2025-08-26T11:28:03.355007,0,1377,3.0,10,3.9
2025-08-26T11:28:03.855211,0,1377,3.0,10,3.6
2025-08-26T11:28:04.355424,0,1377,3.0,10,3.8
2025-08-26T11:28:04.855604,0,1377,3.0,10,3.9
2025-08-26T11:28:05.355831,0,1377,3.0,10,3.5
2025-08-26T11:28:05.856035,6,1383,2.6666666666666665,10,3.6
2025-08-26T11:28:06.356245,0,1383,5.0,10,4.1
2025-08-26T11:28:06.856477,10,1393,3.2,10,6.1
2025-08-26T11:28:07.356719,0,1393,7.0,10,8.4
2025-08-26T11:28:07.856941,10,1403,3.1,10,5.1
2025-08-26T11:28:08.357227,0,1403,1.0,10,3.9
2025-08-26T11:28:08.857463,0,1403,1.0,10,3.8
2025-08-26T11:28:09.357686,0,1403,1.0,10,4.2
2025-08-26T11:28:09.857920,0,1403,1.0,10,3.8
2025-08-26T11:28:10.358157,0,1403,1.0,10,3.6
2025-08-26T11:28:10.858385,0,1403,1.0,10,3.8
2025-08-26T11:28:11.358615,0,1403,1.0,10,3.6
2025-08-26T11:28:11.858839,0,1403,1.0,10,3.6
2025-08-26T11:28:12.359082,0,1403,1.0,10,4.1
2025-08-26T11:28:12.859315,0,1403,1.0,10,3.5
2025-08-26T11:28:13.359546,0,1403,1.0,10,3.6
2025-08-26T11:28:13.859765,0,1403,1.0,10,3.4
2025-08-26T11:28:14.359990,0,1403,1.0,10,3.6
2025-08-26T11:28:14.860228,0,1403,1.0,10,3.6
2025-08-26T11:28:15.360453,0,1403,1.0,10,3.5
2025-08-26T11:28:15.860707,0,1403,1.0,10,3.4
2025-08-26T11:28:16.360986,1,1404,1.0,10,5.6
2025-08-26T11:28:16.861206,0,1404,1.0,10,8.0
2025-08-26T11:28:17.361417,0,1404,1.0,10,3.7
2025-08-26T11:28:17.861629,0,1404,1.0,10,3.7
2025-08-26T11:28:18.361921,10,1414,3.2,10,5.6
2025-08-26T11:28:18.862167,48,1462,3.1666666666666665,10,5.2
2025-08-26T11:28:19.362388,62,1524,3.935483870967742,10,5.5
2025-08-26T11:28:19.862612,0,1524,9.0,10,4.0
2025-08-26T11:28:20.362832,0,1524,9.0,10,3.8
2025-08-26T11:28:20.863087,47,1571,4.404255319148936,10,5.3
2025-08-26T11:28:21.363310,10,1581,3.2,10,3.6
2025-08-26T11:28:21.863537,0,1581,1.0,10,3.7
2025-08-26T11:28:22.363749,0,1581,1.0,10,3.8
2025-08-26T11:28:22.864078,0,1581,1.0,10,4.1
2025-08-26T11:28:23.364311,0,1581,1.0,10,4.2
2025-08-26T11:28:23.864538,0,1581,1.0,10,3.7
2025-08-26T11:28:24.364764,0,1581,1.0,10,3.8
2025-08-26T11:28:24.864998,0,1581,1.0,10,3.7
2025-08-26T11:28:25.365285,0,1581,1.0,10,3.7
2025-08-26T11:28:25.865528,0,1581,1.0,10,3.8
2025-08-26T11:28:26.365737,0,1581,1.0,10,3.6
2025-08-26T11:28:26.865941,0,1581,1.0,10,3.9
2025-08-26T11:28:27.366320,0,1581,1.0,10,3.8
2025-08-26T11:28:27.866688,0,1581,1.0,10,5.6
2025-08-26T11:28:28.367008,0,1581,1.0,10,3.6
2025-08-26T11:28:28.867254,0,1581,1.0,10,4.0
2025-08-26T11:28:29.367481,0,1581,1.0,10,4.7
2025-08-26T11:28:29.867704,0,1581,1.0,10,4.6
2025-08-26T11:28:30.367937,0,1581,1.0,10,6.4
2025-08-26T11:28:30.868171,0,1581,1.0,10,4.6
2025-08-26T11:28:31.368396,0,1581,1.0,10,4.6
2025-08-26T11:28:31.868620,0,1581,1.0,10,4.1
2025-08-26T11:28:32.368841,0,1581,1.0,10,3.7
2025-08-26T11:28:32.869073,0,1581,1.0,10,3.8
2025-08-26T11:28:33.369315,0,1581,1.0,10,6.9
2025-08-26T11:28:33.869549,0,1581,1.0,10,5.0
2025-08-26T11:28:34.369769,0,1581,1.0,10,4.4
2025-08-26T11:28:34.869991,0,1581,1.0,10,4.2
2025-08-26T11:28:35.370249,0,1581,1.0,10,3.9
2025-08-26T11:28:35.870494,0,1581,1.0,10,3.8
2025-08-26T11:28:36.370736,0,1581,1.0,10,4.2
2025-08-26T11:28:36.870978,0,1581,1.0,10,4.0
2025-08-26T11:28:37.371203,0,1581,1.0,10,3.9
2025-08-26T11:28:37.871429,0,1581,1.0,10,3.6
2025-08-26T11:28:38.371657,0,1581,1.0,10,4.1
2025-08-26T11:28:38.871882,0,1581,1.0,10,4.1
2025-08-26T11:28:39.372119,0,1581,1.0,10,4.3
2025-08-26T11:28:39.872335,0,1581,1.0,10,3.6
2025-08-26T11:28:40.372592,0,1581,1.0,10,7.2
2025-08-26T11:28:40.872808,0,1581,1.0,10,5.4
2025-08-26T11:28:41.373022,0,1581,1.0,10,3.6
2025-08-26T11:28:41.873244,0,1581,1.0,10,3.9
2025-08-26T11:28:42.373460,0,1581,1.0,10,3.4
2025-08-26T11:28:42.873677,0,1581,1.0,10,3.4
2025-08-26T11:28:43.373905,0,1581,1.0,10,3.7
2025-08-26T11:28:43.874148,0,1581,1.0,10,3.5
2025-08-26T11:28:44.374357,0,1581,1.0,10,3.6
2025-08-26T11:28:44.874575,0,1581,1.0,10,3.5
2025-08-26T11:28:45.374820,0,1581,1.0,10,3.4
2025-08-26T11:28:45.875043,0,1581,1.0,10,3.6
2025-08-26T11:28:46.375237,0,1581,1.0,10,4.0
2025-08-26T11:28:46.875462,0,1581,1.0,10,3.6
2025-08-26T11:28:47.375663,0,1581,1.0,10,3.4
2025-08-26T11:28:47.875890,0,1581,1.0,10,3.6
2025-08-26T11:28:48.376101,0,1581,1.0,10,3.4
2025-08-26T11:28:48.876314,0,1581,1.0,10,3.3
2025-08-26T11:28:49.376516,0,1581,1.0,10,3.6
2025-08-26T11:28:49.876731,0,1581,1.0,10,3.6
2025-08-26T11:28:50.376992,0,1581,1.0,10,3.4
2025-08-26T11:28:50.877215,0,1581,1.0,10,3.5
2025-08-26T11:28:51.377439,0,1581,1.0,10,3.4
2025-08-26T11:28:51.877662,0,1581,1.0,10,3.5
2025-08-26T11:28:52.377880,0,1581,1.0,10,3.6
2025-08-26T11:28:52.878094,0,1581,1.0,10,3.4
2025-08-26T11:28:53.378322,0,1581,1.0,10,3.4
2025-08-26T11:28:53.878548,0,1581,1.0,10,3.5
2025-08-26T11:28:54.378743,0,1581,1.0,10,3.7
2025-08-26T11:28:54.879026,0,1581,1.0,10,21.9
2025-08-26T11:28:55.379309,0,1581,1.0,10,6.8
2025-08-26T11:28:55.879531,0,1581,1.0,10,23.3
2025-08-26T11:28:56.379744,0,1581,1.0,10,3.8
2025-08-26T11:28:56.879971,0,1581,1.0,10,4.4
2025-08-26T11:28:57.380193,0,1581,1.0,10,5.8
2025-08-26T11:28:57.880420,0,1581,1.0,10,5.6
2025-08-26T11:28:58.380645,0,1581,1.0,10,6.8
2025-08-26T11:28:58.880874,0,1581,1.0,10,7.5
2025-08-26T11:28:59.381177,0,1581,1.0,10,7.1
2025-08-26T11:28:59.881482,0,1581,1.0,10,5.8
2025-08-26T11:29:00.381784,0,1581,1.0,10,5.9
2025-08-26T11:29:00.882091,0,1581,1.0,10,9.0
2025-08-26T11:29:01.382402,0,1581,1.0,10,12.2
2025-08-26T11:29:01.882708,0,1581,1.0,10,10.8
2025-08-26T11:29:02.383005,0,1581,1.0,10,7.2
2025-08-26T11:29:02.883312,0,1581,1.0,10,11.9
2025-08-26T11:29:03.383547,0,1581,1.0,10,13.2
2025-08-26T11:29:03.883795,0,1581,1.0,10,8.8
2025-08-26T11:29:04.384017,0,1581,1.0,10,10.7
2025-08-26T11:29:04.884239,0,1581,1.0,10,7.5
2025-08-26T11:29:05.384461,0,1581,1.0,10,5.7
2025-08-26T11:29:05.884680,0,1581,1.0,10,5.3
2025-08-26T11:29:06.384874,0,1581,1.0,10,6.5
2025-08-26T11:29:06.885065,0,1581,1.0,10,9.2
2025-08-26T11:29:07.385299,0,1581,1.0,10,8.5
2025-08-26T11:29:07.885524,0,1581,1.0,10,6.1
2025-08-26T11:29:08.385761,0,1581,1.0,10,7.0
2025-08-26T11:29:08.885995,0,1581,1.0,10,6.8
2025-08-26T11:29:09.386246,0,1581,1.0,10,7.6
2025-08-26T11:29:09.886488,0,1581,1.0,10,6.9
2025-08-26T11:29:10.386713,0,1581,1.0,10,5.3
2025-08-26T11:29:10.886939,0,1581,1.0,10,5.1
2025-08-26T11:29:11.387166,0,1581,1.0,10,5.1
2025-08-26T11:29:11.887394,0,1581,1.0,10,5.6
2025-08-26T11:29:12.387608,0,1581,1.0,10,5.4
2025-08-26T11:29:12.887833,0,1581,1.0,10,5.2
2025-08-26T11:29:13.388112,0,1581,1.0,10,5.1
2025-08-26T11:29:13.888334,0,1581,1.0,10,5.1
2025-08-26T11:29:14.388555,0,1581,1.0,10,6.4
2025-08-26T11:29:14.888779,0,1581,1.0,10,5.3
2025-08-26T11:29:15.389004,0,1581,1.0,10,5.2
2025-08-26T11:29:15.889248,0,1581,1.0,10,5.5
2025-08-26T11:29:16.389460,0,1581,1.0,10,5.2
2025-08-26T11:29:16.889687,0,1581,1.0,10,5.6
2025-08-26T11:29:17.389908,0,1581,1.0,10,5.6
2025-08-26T11:29:17.890139,0,1581,1.0,10,5.5
2025-08-26T11:29:18.390371,0,1581,1.0,10,5.2
2025-08-26T11:29:18.890582,0,1581,1.0,10,5.2
2025-08-26T11:29:19.390814,0,1581,1.0,10,5.5
2025-08-26T11:29:19.891037,0,1581,1.0,10,5.3
2025-08-26T11:29:20.391242,0,1581,1.0,10,5.1
2025-08-26T11:29:20.891462,0,1581,1.0,10,5.0
2025-08-26T11:29:21.391669,0,1581,1.0,10,5.2
2025-08-26T11:29:21.891895,0,1581,1.0,10,5.0
2025-08-26T11:29:22.392245,0,1581,1.0,10,4.9
2025-08-26T11:29:22.892497,0,1581,1.0,10,3.4
2025-08-26T11:29:23.392702,0,1581,1.0,10,3.4
2025-08-26T11:29:23.892931,0,1581,1.0,10,3.4
2025-08-26T11:29:24.393158,0,1581,1.0,10,3.4
2025-08-26T11:29:24.893400,0,1581,1.0,10,4.2
2025-08-26T11:29:25.393636,0,1581,1.0,10,5.2
2025-08-26T11:29:25.893866,0,1581,1.0,10,4.2
2025-08-26T11:29:26.394081,0,1581,1.0,10,4.7
2025-08-26T11:29:26.894333,0,1581,1.0,10,5.0
2025-08-26T11:29:27.394544,0,1581,1.0,10,3.8
2025-08-26T11:29:27.894767,0,1581,1.0,10,3.8
2025-08-26T11:29:28.394990,0,1581,1.0,10,5.3
2025-08-26T11:29:28.895206,0,1581,1.0,10,3.4
2025-08-26T11:29:29.395433,0,1581,1.0,10,5.1
2025-08-26T11:29:29.895662,0,1581,1.0,10,4.2
2025-08-26T11:29:30.395894,0,1581,1.0,10,4.5
2025-08-26T11:29:30.896124,0,1581,1.0,10,4.1
2025-08-26T11:29:31.396368,0,1581,1.0,10,4.6
2025-08-26T11:29:31.896603,9,1590,1.6666666666666667,10,7.4
2025-08-26T11:29:32.396813,0,1590,1.0,10,4.0
2025-08-26T11:29:32.897057,0,1590,1.0,10,4.9
2025-08-26T11:29:33.397271,0,1590,1.0,10,7.2
2025-08-26T11:29:33.897557,0,1590,1.0,10,4.0
2025-08-26T11:29:34.397788,0,1590,1.0,10,4.4
2025-08-26T11:29:34.898027,0,1590,1.0,10,4.2
2025-08-26T11:29:35.398236,0,1590,1.0,10,3.8
2025-08-26T11:29:35.898456,0,1590,1.0,10,3.7
2025-08-26T11:29:36.398655,0,1590,1.0,10,3.8
2025-08-26T11:29:36.898882,10,1600,1.4,10,4.8
2025-08-26T11:29:37.399102,0,1600,1.0,10,3.6
2025-08-26T11:29:37.899329,0,1600,1.0,10,4.1
2025-08-26T11:29:38.399554,0,1600,1.0,10,3.7
2025-08-26T11:29:38.899785,0,1600,1.0,10,4.5
2025-08-26T11:29:39.400010,0,1600,1.0,10,4.7
2025-08-26T11:29:39.900232,0,1600,1.0,10,3.6
2025-08-26T11:29:40.400465,0,1600,1.0,10,4.0
2025-08-26T11:29:40.900682,0,1600,1.0,10,3.9
2025-08-26T11:29:41.400896,0,1600,1.0,10,3.9
2025-08-26T11:29:41.901213,0,1600,1.0,10,5.0
2025-08-26T11:29:42.401538,0,1600,1.0,10,5.5
2025-08-26T11:29:42.901864,0,1600,1.0,10,3.9
2025-08-26T11:29:43.402295,4,1604,1.75,10,6.7
2025-08-26T11:29:43.902647,0,1604,3.0,10,11.2
2025-08-26T11:29:44.402960,0,1604,3.0,10,8.2
2025-08-26T11:29:44.903310,0,1604,3.0,10,4.6
2025-08-26T11:29:45.403625,0,1604,3.0,10,5.3
2025-08-26T11:29:45.903983,10,1614,1.0,10,6.6
2025-08-26T11:29:46.404313,0,1614,1.0,10,5.0
2025-08-26T11:29:46.904635,0,1614,1.0,10,6.0
2025-08-26T11:29:47.404973,0,1614,1.0,10,5.6
2025-08-26T11:29:47.905298,4,1618,1.75,10,5.9
2025-08-26T11:29:48.405666,10,1628,3.2,10,9.1
2025-08-26T11:29:48.906015,0,1628,7.0,10,4.8
2025-08-26T11:29:49.406312,10,1638,2.3,10,4.6
2025-08-26T11:29:49.906641,0,1638,3.0,10,4.1
2025-08-26T11:29:50.406881,0,1638,3.0,10,3.9
2025-08-26T11:29:50.907128,0,1638,3.0,10,12.0
2025-08-26T11:29:51.407390,0,1638,3.0,10,12.1
2025-08-26T11:29:51.907647,0,1638,3.0,10,12.5
2025-08-26T11:29:52.407957,0,1638,3.0,10,10.1
2025-08-26T11:29:52.908221,0,1638,3.0,10,8.0
2025-08-26T11:29:53.408520,0,1638,3.0,10,8.3
2025-08-26T11:29:53.908764,0,1638,3.0,10,8.3
2025-08-26T11:29:54.409019,0,1638,3.0,10,7.4
2025-08-26T11:29:54.909268,1,1639,1.0,10,7.2
2025-08-26T11:29:55.409528,0,1639,1.0,10,8.0
2025-08-26T11:29:55.909774,0,1639,1.0,10,5.1
2025-08-26T11:29:56.409976,10,1649,2.5,10,8.8
2025-08-26T11:29:56.910210,0,1649,1.0,10,6.4
2025-08-26T11:29:57.410430,10,1659,1.6,10,6.1
2025-08-26T11:29:57.910659,0,1659,4.0,10,4.1
2025-08-26T11:29:58.410902,0,1659,4.0,10,5.1
2025-08-26T11:29:58.911222,0,1659,4.0,10,7.5
2025-08-26T11:29:59.411452,0,1659,4.0,10,6.6
2025-08-26T11:29:59.911690,0,1659,4.0,10,9.7
2025-08-26T11:30:00.411969,0,1659,4.0,10,5.6
2025-08-26T11:30:00.912233,0,1659,4.0,10,6.4
2025-08-26T11:30:01.412456,0,1659,4.0,10,5.1
2025-08-26T11:30:01.912777,0,1659,4.0,10,8.7
2025-08-26T11:30:02.413080,0,1659,4.0,10,10.7
2025-08-26T11:30:02.913458,0,1659,4.0,10,11.9
2025-08-26T11:30:03.413791,0,1659,4.0,10,10.7
2025-08-26T11:30:03.914116,0,1659,4.0,10,6.4
2025-08-26T11:30:04.414469,2,1661,1.0,10,8.7
2025-08-26T11:30:04.914780,10,1671,1.4,10,8.7
2025-08-26T11:30:05.415107,0,1671,1.0,10,4.6
2025-08-26T11:30:05.915415,0,1671,1.0,10,3.6
2025-08-26T11:30:06.415732,0,1671,1.0,10,4.4
2025-08-26T11:30:06.916124,0,1671,1.0,10,4.4
2025-08-26T11:30:07.416491,0,1671,1.0,10,5.6
2025-08-26T11:30:07.916833,0,1671,1.0,10,5.8
2025-08-26T11:30:08.417140,0,1671,1.0,10,6.0
2025-08-26T11:30:08.917447,0,1671,1.0,10,4.3
2025-08-26T11:30:09.417746,0,1671,1.0,10,5.7
2025-08-26T11:30:09.918137,0,1671,1.0,10,4.1
2025-08-26T11:30:10.418447,0,1671,1.0,10,3.9
2025-08-26T11:30:10.918668,0,1671,1.0,10,3.6
2025-08-26T11:30:11.418904,0,1671,1.0,10,4.4
2025-08-26T11:30:11.919159,5,1676,1.6,10,4.5
2025-08-26T11:30:12.419566,10,1686,1.8,10,8.1
2025-08-26T11:30:12.919866,0,1686,1.0,10,3.9
2025-08-26T11:30:13.420087,10,1696,2.1,10,4.8
2025-08-26T11:30:13.920314,0,1696,1.0,10,3.8
2025-08-26T11:30:14.420535,0,1696,1.0,10,3.7
2025-08-26T11:30:14.920773,0,1696,1.0,10,4.4
2025-08-26T11:30:15.420998,0,1696,1.0,10,4.3
2025-08-26T11:30:15.921238,3,1699,2.0,10,4.8
2025-08-26T11:30:16.421518,10,1709,1.6,10,4.3
2025-08-26T11:30:16.921748,0,1709,1.0,10,3.7
2025-08-26T11:30:17.421983,39,1748,3.769230769230769,10,8.7
2025-08-26T11:30:17.922240,10,1758,3.8,10,7.3
2025-08-26T11:30:18.422482,0,1758,8.0,10,7.3
2025-08-26T11:30:18.922713,0,1758,8.0,10,5.4
2025-08-26T11:30:19.422946,0,1758,8.0,10,5.4
2025-08-26T11:30:19.923296,9,1767,1.1111111111111112,10,7.8
2025-08-26T11:30:20.423542,10,1777,3.8,10,6.1
2025-08-26T11:30:20.923799,10,1787,1.4,10,4.0
2025-08-26T11:30:21.424070,0,1787,3.0,10,3.5
2025-08-26T11:30:21.924314,0,1787,3.0,10,3.4
2025-08-26T11:30:22.424545,0,1787,3.0,10,3.8
2025-08-26T11:30:22.924823,0,1787,3.0,10,3.7
2025-08-26T11:30:23.425103,0,1787,3.0,10,3.8
2025-08-26T11:30:23.925335,0,1787,3.0,10,3.7
2025-08-26T11:30:24.425602,0,1787,3.0,10,4.5
2025-08-26T11:30:24.925825,8,1795,1.125,10,4.3
2025-08-26T11:30:25.426045,0,1795,1.0,10,4.6
2025-08-26T11:30:25.926239,0,1795,1.0,10,3.5
2025-08-26T11:30:26.426448,0,1795,1.0,10,3.4
2025-08-26T11:30:26.926666,0,1795,1.0,10,3.7
2025-08-26T11:30:27.426877,0,1795,1.0,10,3.9
2025-08-26T11:30:27.927150,10,1805,1.3,10,10.7
2025-08-26T11:30:28.427391,0,1805,3.0,10,10.5
2025-08-26T11:30:28.927638,0,1805,3.0,10,11.6
2025-08-26T11:30:29.427933,0,1805,3.0,10,9.9
2025-08-26T11:30:29.928207,0,1805,3.0,10,4.3
2025-08-26T11:30:30.428478,0,1805,3.0,10,4.8
2025-08-26T11:30:30.928729,0,1805,3.0,10,4.6
2025-08-26T11:30:31.428983,0,1805,3.0,10,3.4
2025-08-26T11:30:31.929211,0,1805,3.0,10,3.6
2025-08-26T11:30:32.429437,0,1805,3.0,10,3.6
2025-08-26T11:30:32.929683,0,1805,3.0,10,5.0
2025-08-26T11:30:33.429923,0,1805,3.0,10,8.5
2025-08-26T11:30:33.930146,0,1805,3.0,10,4.5
2025-08-26T11:30:34.430348,0,1805,3.0,10,4.0
2025-08-26T11:30:34.930589,0,1805,3.0,10,9.1
2025-08-26T11:30:35.430901,0,1805,3.0,10,9.3
2025-08-26T11:30:35.931142,0,1805,3.0,10,9.6
2025-08-26T11:30:36.431388,0,1805,3.0,10,9.4
2025-08-26T11:30:36.931660,0,1805,3.0,10,3.8
2025-08-26T11:30:37.431883,0,1805,3.0,10,3.7
2025-08-26T11:30:37.932146,0,1805,3.0,10,7.6
2025-08-26T11:30:38.432436,0,1805,3.0,10,9.6
2025-08-26T11:30:38.932664,0,1805,3.0,10,9.8
2025-08-26T11:30:39.432914,0,1805,3.0,10,9.9
2025-08-26T11:30:39.933253,0,1805,3.0,10,4.3
2025-08-26T11:30:40.433539,0,1805,3.0,10,3.4
2025-08-26T11:30:40.933795,0,1805,3.0,10,3.6
2025-08-26T11:30:41.434052,0,1805,3.0,10,3.9
2025-08-26T11:30:41.934225,0,1805,3.0,10,3.6
2025-08-26T11:30:42.434483,0,1805,3.0,10,3.5
2025-08-26T11:30:42.934725,0,1805,3.0,10,6.9
2025-08-26T11:30:43.434994,16,1821,2.75,10,18.1
2025-08-26T11:30:43.935240,0,1821,1.0,10,17.5
2025-08-26T11:30:44.470080,10,1831,1.4285714285714286,10,18.1
2025-08-26T11:30:44.978413,10,1841,1.7692307692307692,10,13.3
2025-08-26T11:30:45.478676,10,1851,1.3,10,7.0
2025-08-26T11:30:45.978955,0,1851,1.0,10,4.2
2025-08-26T11:30:46.479194,1,1852,1.0,10,4.3
2025-08-26T11:30:46.979490,0,1852,1.0,10,3.7
2025-08-26T11:30:47.480072,0,1852,1.0,10,3.5
2025-08-26T11:30:47.980799,0,1852,1.0,10,3.2
2025-08-26T11:30:48.481115,0,1852,1.0,10,4.6
2025-08-26T11:30:48.981675,0,1852,1.0,10,2.4
2025-08-26T11:30:49.482036,0,1852,1.0,10,2.1
2025-08-26T11:30:49.982564,0,1852,1.0,10,3.3
2025-08-26T11:30:50.483157,0,1852,1.0,10,1.6
2025-08-26T11:30:50.983725,0,1852,1.0,10,1.8
2025-08-26T11:30:51.484306,0,1852,1.0,10,1.6
2025-08-26T11:30:51.984948,0,1852,1.0,10,1.9
2025-08-26T11:30:52.485269,0,1852,1.0,10,4.9
2025-08-26T11:30:52.985807,0,1852,1.0,10,4.0
2025-08-26T11:30:53.486085,0,1852,1.0,10,4.9
2025-08-26T11:30:53.986649,0,1852,1.0,10,4.0
2025-08-26T11:30:54.487283,0,1852,1.0,10,2.0
2025-08-26T11:30:54.987847,0,1852,1.0,10,1.8
2025-08-26T11:30:55.488447,0,1852,1.0,10,2.0
2025-08-26T11:30:55.988998,0,1852,1.0,10,2.2
2025-08-26T11:30:56.489500,0,1852,1.0,10,2.7
2025-08-26T11:30:56.990032,0,1852,1.0,10,2.5
2025-08-26T11:30:57.490578,0,1852,1.0,10,2.3
2025-08-26T11:30:57.991133,0,1852,1.0,10,1.9
2025-08-26T11:30:58.491664,0,1852,1.0,10,2.0
2025-08-26T11:30:58.992212,0,1852,1.0,10,3.2
2025-08-26T11:30:59.492732,0,1852,1.0,10,2.1
2025-08-26T11:30:59.993374,0,1852,1.0,10,2.4
2025-08-26T11:31:00.493918,0,1852,1.0,10,2.1
2025-08-26T11:31:00.994535,0,1852,1.0,10,2.3
2025-08-26T11:31:01.495065,0,1852,1.0,10,1.8
2025-08-26T11:31:01.995623,0,1852,1.0,10,1.8
2025-08-26T11:31:02.496680,0,1852,1.0,10,2.7
2025-08-26T11:31:02.997533,0,1852,1.0,10,1.8
2025-08-26T11:31:03.498474,0,1852,1.0,10,2.3
2025-08-26T11:31:03.999447,0,1852,1.0,10,1.8
2025-08-26T11:31:04.500430,0,1852,1.0,10,1.6
2025-08-26T11:31:05.000973,0,1852,1.0,10,1.4
2025-08-26T11:31:05.501419,0,1852,1.0,10,1.6
2025-08-26T11:31:06.001890,0,1852,1.0,10,1.8
2025-08-26T11:31:06.502382,0,1852,1.0,10,1.9
2025-08-26T11:31:07.002944,0,1852,1.0,10,2.6
2025-08-26T11:31:07.503510,0,1852,1.0,10,2.3
2025-08-26T11:31:08.004022,0,1852,1.0,10,2.1
2025-08-26T11:31:08.504545,0,1852,1.0,10,2.1
2025-08-26T11:31:09.005122,0,1852,1.0,10,1.9
2025-08-26T11:31:09.505660,0,1852,1.0,10,2.1
2025-08-26T11:31:10.006290,0,1852,1.0,10,2.3
2025-08-26T11:31:10.506904,0,1852,1.0,10,2.1
2025-08-26T11:31:11.007495,0,1852,1.0,10,2.8
2025-08-26T11:31:11.507888,0,1852,1.0,10,3.2
2025-08-26T11:31:12.008413,0,1852,1.0,10,4.6
2025-08-26T11:31:12.509021,0,1852,1.0,10,3.3
2025-08-26T11:31:13.009594,0,1852,1.0,10,2.0
2025-08-26T11:31:13.510142,0,1852,1.0,10,1.6
2025-08-26T11:31:14.010634,0,1852,1.0,10,2.7
2025-08-26T11:31:14.511196,0,1852,1.0,10,1.9
2025-08-26T11:31:15.011746,0,1852,1.0,10,2.5
2025-08-26T11:31:15.512323,0,1852,1.0,10,2.5
2025-08-26T11:31:16.012830,0,1852,1.0,10,1.8
2025-08-26T11:31:16.513422,0,1852,1.0,10,3.1
2025-08-26T11:31:17.013899,0,1852,1.0,10,2.3
2025-08-26T11:31:17.514501,0,1852,1.0,10,1.9
2025-08-26T11:31:18.015033,0,1852,1.0,10,2.3
2025-08-26T11:31:18.515625,0,1852,1.0,10,3.3
2025-08-26T11:31:19.016222,0,1852,1.0,10,1.9
2025-08-26T11:31:19.516795,0,1852,1.0,10,1.8
2025-08-26T11:31:20.017411,0,1852,1.0,10,2.1
2025-08-26T11:31:20.517970,0,1852,1.0,10,2.0
2025-08-26T11:31:21.018519,0,1852,1.0,10,1.8
2025-08-26T11:31:21.519214,0,1852,1.0,10,3.7
2025-08-26T11:31:22.019524,0,1852,1.0,10,5.8
2025-08-26T11:31:22.519796,0,1852,1.0,10,4.2
2025-08-26T11:31:23.020330,0,1852,1.0,10,3.8
2025-08-26T11:31:23.520946,0,1852,1.0,10,4.1
2025-08-26T11:31:24.021577,0,1852,1.0,10,3.6
2025-08-26T11:31:24.522308,0,1852,1.0,10,3.4
2025-08-26T11:31:25.022899,0,1852,1.0,10,3.2
2025-08-26T11:31:25.523508,0,1852,1.0,10,2.8
2025-08-26T11:31:26.024117,0,1852,1.0,10,2.1
2025-08-26T11:31:26.524406,0,1852,1.0,10,5.2
2025-08-26T11:31:27.024890,0,1852,1.0,10,3.0
2025-08-26T11:31:27.525419,0,1852,1.0,10,5.4
2025-08-26T11:31:28.026011,0,1852,1.0,10,3.5
2025-08-26T11:31:28.526608,0,1852,1.0,10,2.2
2025-08-26T11:31:29.027247,0,1852,1.0,10,1.9
2025-08-26T11:31:29.527823,0,1852,1.0,10,3.6
2025-08-26T11:31:30.028509,0,1852,1.0,10,3.2
2025-08-26T11:31:30.529064,0,1852,1.0,10,2.2
2025-08-26T11:31:31.029642,0,1852,1.0,10,1.9
2025-08-26T11:31:31.530179,0,1852,1.0,10,4.6
2025-08-26T11:31:32.030613,0,1852,1.0,10,3.8
2025-08-26T11:31:32.531267,0,1852,1.0,10,6.2
2025-08-26T11:31:33.031564,0,1852,1.0,10,6.5
2025-08-26T11:31:33.532142,0,1852,1.0,10,2.9
2025-08-26T11:31:34.032680,0,1852,1.0,10,2.4
2025-08-26T11:31:34.533236,0,1852,1.0,10,2.9
2025-08-26T11:31:35.033774,0,1852,1.0,10,4.0
2025-08-26T11:31:35.534402,0,1852,1.0,10,2.5
2025-08-26T11:31:36.035054,0,1852,1.0,10,2.7
2025-08-26T11:31:36.535673,0,1852,1.0,10,5.8
2025-08-26T11:31:37.036302,0,1852,1.0,10,2.3
2025-08-26T11:31:37.536868,0,1852,1.0,10,4.3
2025-08-26T11:31:38.037423,0,1852,1.0,10,5.8
2025-08-26T11:31:38.538224,0,1852,1.0,10,2.4
2025-08-26T11:31:39.039054,0,1852,1.0,10,1.9
2025-08-26T11:31:39.539467,0,1852,1.0,10,2.8
2025-08-26T11:31:40.039809,0,1852,1.0,10,4.3
2025-08-26T11:31:40.540644,0,1852,1.0,10,3.8
2025-08-26T11:31:41.041544,0,1852,1.0,10,4.2
2025-08-26T11:31:41.542434,0,1852,1.0,10,3.6
2025-08-26T11:31:42.042883,0,1852,1.0,10,7.7
2025-08-26T11:31:42.543244,0,1852,1.0,10,6.8
2025-08-26T11:31:43.043934,0,1852,1.0,10,4.3
2025-08-26T11:31:43.544423,0,1852,1.0,10,5.0
2025-08-26T11:31:44.044990,0,1852,1.0,10,3.7
2025-08-26T11:31:44.545638,0,1852,1.0,10,4.3
2025-08-26T11:31:45.045965,0,1852,1.0,10,4.8
2025-08-26T11:31:45.546567,0,1852,1.0,10,3.7
2025-08-26T11:31:46.047155,0,1852,1.0,10,4.1
2025-08-26T11:31:46.547756,0,1852,1.0,10,6.6
2025-08-26T11:31:47.048301,0,1852,1.0,10,8.4
2025-08-26T11:31:47.548748,0,1852,1.0,10,8.7
2025-08-26T11:31:48.049297,0,1852,1.0,10,6.5
2025-08-26T11:31:48.549589,0,1852,1.0,10,5.6
2025-08-26T11:31:49.049826,0,1852,1.0,10,5.2
2025-08-26T11:31:49.550068,0,1852,1.0,10,4.8
2025-08-26T11:31:50.050569,0,1852,1.0,10,3.7
2025-08-26T11:31:50.550864,0,1852,1.0,10,4.9
2025-08-26T11:31:51.051103,0,1852,1.0,10,4.3
2025-08-26T11:31:51.551338,0,1852,1.0,10,3.7
2025-08-26T11:31:52.051581,0,1852,1.0,10,6.0
2025-08-26T11:31:52.551834,0,1852,1.0,10,4.5
2025-08-26T11:31:53.052115,0,1852,1.0,10,4.9
2025-08-26T11:31:53.552367,0,1852,1.0,10,4.1
2025-08-26T11:31:54.052611,0,1852,1.0,10,4.1
2025-08-26T11:31:54.552843,0,1852,1.0,10,3.9
2025-08-26T11:31:55.053108,0,1852,1.0,10,7.4
2025-08-26T11:31:55.553466,0,1852,1.0,10,4.1
2025-08-26T11:31:56.054029,0,1852,1.0,10,4.0
2025-08-26T11:31:56.554687,0,1852,1.0,10,4.6
2025-08-26T11:31:57.055609,0,1852,1.0,10,5.3
2025-08-26T11:31:57.556614,0,1852,1.0,10,4.9
2025-08-26T11:31:58.057537,0,1852,1.0,10,5.4
2025-08-26T11:31:58.558159,0,1852,1.0,10,4.2
2025-08-26T11:31:59.058790,0,1852,1.0,10,3.9
2025-08-26T11:31:59.559619,0,1852,1.0,10,4.0
2025-08-26T11:32:00.060703,0,1852,1.0,10,4.1
2025-08-26T11:32:00.561417,0,1852,1.0,10,3.6
2025-08-26T11:32:01.062058,0,1852,1.0,10,4.6
2025-08-26T11:32:01.562730,0,1852,1.0,10,3.6
2025-08-26T11:32:02.063060,0,1852,1.0,10,3.5
2025-08-26T11:32:02.563330,0,1852,1.0,10,3.6
2025-08-26T11:32:03.063560,0,1852,1.0,10,3.1
2025-08-26T11:32:03.563846,0,1852,1.0,10,3.3
2025-08-26T11:32:04.064088,0,1852,1.0,10,2.9
2025-08-26T11:32:04.564328,0,1852,1.0,10,3.9
2025-08-26T11:32:05.064584,0,1852,1.0,10,3.7
2025-08-26T11:32:05.564834,0,1852,1.0,10,6.2
2025-08-26T11:32:06.065106,0,1852,1.0,10,3.5
2025-08-26T11:32:06.565627,0,1852,1.0,10,4.6
2025-08-26T11:32:07.065879,0,1852,1.0,10,4.3
2025-08-26T11:32:07.566450,0,1852,1.0,10,4.6
2025-08-26T11:32:08.066927,0,1852,1.0,10,4.7
2025-08-26T11:32:08.567493,0,1852,1.0,10,4.2
2025-08-26T11:32:09.068073,0,1852,1.0,10,4.1
2025-08-26T11:32:09.568641,0,1852,1.0,10,4.7
2025-08-26T11:32:10.069332,0,1852,1.0,10,4.1
2025-08-26T11:32:10.569898,0,1852,1.0,10,5.0
2025-08-26T11:32:11.070454,0,1852,1.0,10,4.3
2025-08-26T11:32:11.571041,0,1852,1.0,10,3.8
2025-08-26T11:32:12.071648,0,1852,1.0,10,3.5
2025-08-26T11:32:12.572347,0,1852,1.0,10,3.8
2025-08-26T11:32:13.072690,0,1852,1.0,10,4.3
2025-08-26T11:32:13.572988,0,1852,1.0,10,3.9
2025-08-26T11:32:14.073289,0,1852,1.0,10,3.5
2025-08-26T11:32:14.573583,0,1852,1.0,10,3.6
2025-08-26T11:32:15.073846,0,1852,1.0,10,3.1
2025-08-26T11:32:15.574083,0,1852,1.0,10,4.0
2025-08-26T11:32:16.074348,0,1852,1.0,10,3.9
2025-08-26T11:32:16.574601,0,1852,1.0,10,5.9
2025-08-26T11:32:17.074861,0,1852,1.0,10,3.4
2025-08-26T11:32:17.575204,0,1852,1.0,10,4.2
2025-08-26T11:32:18.075460,0,1852,1.0,10,3.8
2025-08-26T11:32:18.575727,0,1852,1.0,10,4.3
2025-08-26T11:32:19.075978,0,1852,1.0,10,3.2
2025-08-26T11:32:19.576233,0,1852,1.0,10,5.8
2025-08-26T11:32:20.076787,0,1852,1.0,10,4.0
2025-08-26T11:32:20.577417,0,1852,1.0,10,3.2
2025-08-26T11:32:21.078125,0,1852,1.0,10,3.6
2025-08-26T11:32:21.578781,0,1852,1.0,10,5.3
2025-08-26T11:32:22.079383,0,1852,1.0,10,4.2
2025-08-26T11:32:22.580017,0,1852,1.0,10,3.9
2025-08-26T11:32:23.080566,0,1852,1.0,10,3.6
2025-08-26T11:32:23.581137,0,1852,1.0,10,4.1
2025-08-26T11:32:24.081749,0,1852,1.0,10,3.8
2025-08-26T11:32:24.582342,0,1852,1.0,10,3.9
2025-08-26T11:32:25.083017,0,1852,1.0,10,4.0
2025-08-26T11:32:25.583429,0,1852,1.0,10,4.5
2025-08-26T11:32:26.083704,0,1852,1.0,10,4.1
2025-08-26T11:32:26.583976,0,1852,1.0,10,3.6
2025-08-26T11:32:27.084281,0,1852,1.0,10,3.0
2025-08-26T11:32:27.584643,0,1852,1.0,10,3.6
2025-08-26T11:32:28.085025,0,1852,1.0,10,3.4
2025-08-26T11:32:28.585425,0,1852,1.0,10,3.5
2025-08-26T11:32:29.085799,0,1852,1.0,10,3.1
2025-08-26T11:32:29.586139,0,1852,1.0,10,3.4
2025-08-26T11:32:30.086535,0,1852,1.0,10,3.0
2025-08-26T11:32:30.587394,0,1852,1.0,10,2.9
2025-08-26T11:32:31.087997,0,1852,1.0,10,3.2
2025-08-26T11:32:31.588517,0,1852,1.0,10,3.6
2025-08-26T11:32:32.089115,0,1852,1.0,10,3.5
2025-08-26T11:32:32.589678,0,1852,1.0,10,4.1
2025-08-26T11:32:33.090258,0,1852,1.0,10,3.8
2025-08-26T11:32:33.590883,0,1852,1.0,10,3.9
2025-08-26T11:32:34.091538,0,1852,1.0,10,5.7
2025-08-26T11:32:34.592184,0,1852,1.0,10,4.3
2025-08-26T11:32:35.092768,0,1852,1.0,10,3.8
2025-08-26T11:32:35.593117,0,1852,1.0,10,4.5
2025-08-26T11:32:36.093352,0,1852,1.0,10,3.6
2025-08-26T11:32:36.593608,0,1852,1.0,10,6.5
2025-08-26T11:32:37.093983,0,1852,1.0,10,3.4
2025-08-26T11:32:37.594264,0,1852,1.0,10,4.3
2025-08-26T11:32:38.094513,0,1852,1.0,10,4.6
2025-08-26T11:32:38.594785,0,1852,1.0,10,4.5
2025-08-26T11:32:39.095065,0,1852,1.0,10,3.2
2025-08-26T11:32:39.595341,0,1852,1.0,10,3.2
2025-08-26T11:32:40.095598,0,1852,1.0,10,3.5
2025-08-26T11:32:40.596036,0,1852,1.0,10,5.4
2025-08-26T11:32:41.096593,0,1852,1.0,10,4.6
2025-08-26T11:32:41.596936,0,1852,1.0,10,6.2
2025-08-26T11:32:42.097532,0,1852,1.0,10,5.3
2025-08-26T11:32:42.598136,0,1852,1.0,10,5.1
2025-08-26T11:32:43.098807,0,1852,1.0,10,4.4
2025-08-26T11:32:43.599371,0,1852,1.0,10,4.4
2025-08-26T11:32:44.099735,0,1852,1.0,10,4.3
2025-08-26T11:32:44.599991,0,1852,1.0,10,4.0
2025-08-26T11:32:45.100274,0,1852,1.0,10,4.5
2025-08-26T11:32:45.600629,0,1852,1.0,10,3.4
2025-08-26T11:32:46.100962,0,1852,1.0,10,5.6
2025-08-26T11:32:46.601361,0,1852,1.0,10,4.0
2025-08-26T11:32:47.101700,0,1852,1.0,10,3.1
2025-08-26T11:32:47.602038,0,1852,1.0,10,3.9
2025-08-26T11:32:48.102375,0,1852,1.0,10,3.2
2025-08-26T11:32:48.603268,0,1852,1.0,10,3.1
2025-08-26T11:32:49.104197,0,1852,1.0,10,3.5
2025-08-26T11:32:49.604890,0,1852,1.0,10,3.5
2025-08-26T11:32:50.105475,0,1852,1.0,10,3.9
2025-08-26T11:32:50.606126,0,1852,1.0,10,3.9
2025-08-26T11:32:51.106731,0,1852,1.0,10,3.8
2025-08-26T11:32:51.607386,0,1852,1.0,10,3.5
2025-08-26T11:32:52.107942,0,1852,1.0,10,3.8
2025-08-26T11:32:52.608257,0,1852,1.0,10,4.1
2025-08-26T11:32:53.108513,0,1852,1.0,10,4.2
2025-08-26T11:32:53.608761,0,1852,1.0,10,3.6
2025-08-26T11:32:54.108998,0,1852,1.0,10,3.1
2025-08-26T11:32:54.609250,0,1852,1.0,10,3.6
2025-08-26T11:32:55.109514,0,1852,1.0,10,4.1
2025-08-26T11:32:55.609771,0,1852,1.0,10,3.5
2025-08-26T11:32:56.110122,0,1852,1.0,10,3.0
2025-08-26T11:32:56.610389,0,1852,1.0,10,3.1
2025-08-26T11:32:57.110626,0,1852,1.0,10,3.1
2025-08-26T11:32:57.610881,0,1852,1.0,10,3.6
2025-08-26T11:32:58.111324,0,1852,1.0,10,3.1
2025-08-26T11:32:58.611860,0,1852,1.0,10,3.1
2025-08-26T11:32:59.112571,0,1852,1.0,10,3.1
2025-08-26T11:32:59.613228,0,1852,1.0,10,3.1
2025-08-26T11:33:00.113801,0,1852,1.0,10,3.6
2025-08-26T11:33:00.614384,0,1852,1.0,10,4.1
2025-08-26T11:33:01.114999,0,1852,1.0,10,3.4
2025-08-26T11:33:01.615678,0,1852,1.0,10,3.6
2025-08-26T11:33:02.116070,0,1852,1.0,10,3.1
2025-08-26T11:33:02.616332,0,1852,1.0,10,3.6
2025-08-26T11:33:03.116571,0,1852,1.0,10,3.0
2025-08-26T11:33:03.616857,0,1852,1.0,10,3.0
2025-08-26T11:33:04.117119,0,1852,1.0,10,2.8
2025-08-26T11:33:04.617387,0,1852,1.0,10,2.9
2025-08-26T11:33:05.117652,0,1852,1.0,10,2.9
2025-08-26T11:33:05.617959,0,1852,1.0,10,2.7
2025-08-26T11:33:06.118273,0,1852,1.0,10,3.8
2025-08-26T11:33:06.618573,0,1852,1.0,10,3.3
2025-08-26T11:33:07.118827,0,1852,1.0,10,3.7
2025-08-26T11:33:07.619081,0,1852,1.0,10,4.1
2025-08-26T11:33:08.119583,0,1852,1.0,10,3.3
2025-08-26T11:33:08.620180,0,1852,1.0,10,3.4
2025-08-26T11:33:09.120717,0,1852,1.0,10,3.7
2025-08-26T11:33:09.621409,0,1852,1.0,10,3.5
2025-08-26T11:33:10.122259,0,1852,1.0,10,3.3
2025-08-26T11:33:10.622877,0,1852,1.0,10,3.8
2025-08-26T11:33:11.123495,0,1852,1.0,10,3.3
2025-08-26T11:33:11.624084,0,1852,1.0,10,3.3
2025-08-26T11:33:12.124530,0,1852,1.0,10,4.3
2025-08-26T11:33:12.624813,0,1852,1.0,10,4.4
2025-08-26T11:33:13.125112,0,1852,1.0,10,5.4
2025-08-26T11:33:13.625358,0,1852,1.0,10,3.9
2025-08-26T11:33:14.125605,0,1852,1.0,10,3.0
2025-08-26T11:33:14.625912,0,1852,1.0,10,2.8
2025-08-26T11:33:15.126207,0,1852,1.0,10,3.1
2025-08-26T11:33:15.626461,0,1852,1.0,10,3.0
2025-08-26T11:33:16.126744,0,1852,1.0,10,3.5
2025-08-26T11:33:16.627110,0,1852,1.0,10,3.8
2025-08-26T11:33:17.127484,0,1852,1.0,10,4.8
2025-08-26T11:33:17.627852,0,1852,1.0,10,4.3
2025-08-26T11:33:18.128163,0,1852,1.0,10,3.6
2025-08-26T11:33:18.628469,0,1852,1.0,10,3.3
2025-08-26T11:33:19.129172,0,1852,1.0,10,4.6
2025-08-26T11:33:19.630022,0,1852,1.0,10,3.3
2025-08-26T11:33:20.130988,0,1852,1.0,10,3.1
2025-08-26T11:33:20.631950,0,1852,1.0,10,3.3
2025-08-26T11:33:21.132905,0,1852,1.0,10,3.1
2025-08-26T11:33:21.633825,0,1852,1.0,10,3.5
2025-08-26T11:33:22.134712,0,1852,1.0,10,3.6
2025-08-26T11:33:22.635714,0,1852,1.0,10,5.4
2025-08-26T11:33:23.136703,0,1852,1.0,10,6.1
2025-08-26T11:33:23.637661,0,1852,1.0,10,3.5
2025-08-26T11:33:24.138641,0,1852,1.0,10,4.3
2025-08-26T11:33:24.639337,0,1852,1.0,10,4.1
2025-08-26T11:33:25.139933,0,1852,1.0,10,3.6
2025-08-26T11:33:25.640412,0,1852,1.0,10,4.4
2025-08-26T11:33:26.140727,0,1852,1.0,10,6.7
2025-08-26T11:33:26.640990,0,1852,1.0,10,4.6
2025-08-26T11:33:27.141260,0,1852,1.0,10,4.2
2025-08-26T11:33:27.641552,0,1852,1.0,10,3.6
2025-08-26T11:33:28.141809,0,1852,1.0,10,3.5
2025-08-26T11:33:28.642148,0,1852,1.0,10,5.7
2025-08-26T11:33:29.142481,0,1852,1.0,10,4.9
2025-08-26T11:33:29.642897,0,1852,1.0,10,3.1
2025-08-26T11:33:30.143229,0,1852,1.0,10,4.8
2025-08-26T11:33:30.643760,0,1852,1.0,10,4.0
2025-08-26T11:33:31.144328,0,1852,1.0,10,5.5
2025-08-26T11:33:31.644874,0,1852,1.0,10,5.1
2025-08-26T11:33:32.145431,0,1852,1.0,10,4.1
2025-08-26T11:33:32.645988,0,1852,1.0,10,5.2
2025-08-26T11:33:33.146418,0,1852,1.0,10,6.4
2025-08-26T11:33:33.646928,0,1852,1.0,10,3.7
2025-08-26T11:33:34.147502,0,1852,1.0,10,3.4
2025-08-26T11:33:34.648051,0,1852,1.0,10,3.4
2025-08-26T11:33:35.148354,0,1852,1.0,10,3.6
2025-08-26T11:33:35.648764,0,1852,1.0,10,3.9
2025-08-26T11:33:36.149076,0,1852,1.0,10,3.8
2025-08-26T11:33:36.649368,0,1852,1.0,10,4.1
2025-08-26T11:33:37.149640,0,1852,1.0,10,3.1
2025-08-26T11:33:37.649926,0,1852,1.0,10,3.4
2025-08-26T11:33:38.150193,0,1852,1.0,10,3.1
2025-08-26T11:33:38.650461,0,1852,1.0,10,3.2
2025-08-26T11:33:39.150742,0,1852,1.0,10,3.1
2025-08-26T11:33:39.651101,0,1852,1.0,10,3.3
2025-08-26T11:33:40.151366,0,1852,1.0,10,3.3
2025-08-26T11:33:40.651619,0,1852,1.0,10,3.7
2025-08-26T11:33:41.151864,0,1852,1.0,10,3.5
2025-08-26T11:33:41.652485,0,1852,1.0,10,3.4
2025-08-26T11:33:42.153050,0,1852,1.0,10,4.4
2025-08-26T11:33:42.653689,0,1852,1.0,10,4.5
2025-08-26T11:33:43.154299,0,1852,1.0,10,3.7
2025-08-26T11:33:43.654981,0,1852,1.0,10,3.6
2025-08-26T11:33:44.155856,0,1852,1.0,10,3.7
2025-08-26T11:33:44.656604,0,1852,1.0,10,3.7
2025-08-26T11:33:45.157496,0,1852,1.0,10,3.3
2025-08-26T11:33:45.658436,0,1852,1.0,10,4.4
2025-08-26T11:33:46.159509,0,1852,1.0,10,4.5
2025-08-26T11:33:46.660183,0,1852,1.0,10,4.0
2025-08-26T11:33:47.160788,0,1852,1.0,10,3.9
2025-08-26T11:33:47.661405,0,1852,1.0,10,3.9
2025-08-26T11:33:48.161713,0,1852,1.0,10,3.7
2025-08-26T11:33:48.661972,0,1852,1.0,10,3.3
2025-08-26T11:33:49.162257,0,1852,1.0,10,3.5
2025-08-26T11:33:49.662516,0,1852,1.0,10,3.6
2025-08-26T11:33:50.162876,0,1852,1.0,10,3.9
2025-08-26T11:33:50.663150,0,1852,1.0,10,4.0
2025-08-26T11:33:51.163430,0,1852,1.0,10,3.2
2025-08-26T11:33:51.663686,0,1852,1.0,10,3.1
2025-08-26T11:33:52.163945,0,1852,1.0,10,3.3
2025-08-26T11:33:52.664209,0,1852,1.0,10,3.0
2025-08-26T11:33:53.164521,0,1852,1.0,10,3.1
2025-08-26T11:33:53.665079,0,1852,1.0,10,3.1
2025-08-26T11:33:54.165696,0,1852,1.0,10,3.1
2025-08-26T11:33:54.666292,0,1852,1.0,10,3.6
2025-08-26T11:33:55.166871,0,1852,1.0,10,3.7
2025-08-26T11:33:55.667468,0,1852,1.0,10,3.5
2025-08-26T11:33:56.168064,0,1852,1.0,10,3.3
2025-08-26T11:33:56.668654,0,1852,1.0,10,3.5
2025-08-26T11:33:57.169284,0,1852,1.0,10,3.6
2025-08-26T11:33:57.669664,0,1852,1.0,10,3.7
2025-08-26T11:33:58.169974,0,1852,1.0,10,3.6
2025-08-26T11:33:58.670249,0,1852,1.0,10,3.0
2025-08-26T11:33:59.170502,0,1852,1.0,10,3.2
2025-08-26T11:33:59.670789,0,1852,1.0,10,3.2
2025-08-26T11:34:00.171060,0,1852,1.0,10,3.0
2025-08-26T11:34:00.671325,0,1852,1.0,10,3.1
2025-08-26T11:34:01.171592,0,1852,1.0,10,3.7
2025-08-26T11:34:01.671839,0,1852,1.0,10,3.3
2025-08-26T11:34:02.172111,0,1852,1.0,10,3.6
2025-08-26T11:34:02.672364,0,1852,1.0,10,3.8
2025-08-26T11:34:03.172606,0,1852,1.0,10,3.6
2025-08-26T11:34:03.672839,0,1852,1.0,10,3.3
2025-08-26T11:34:04.173439,0,1852,1.0,10,2.9
2025-08-26T11:34:04.673994,0,1852,1.0,10,3.7
2025-08-26T11:34:05.174544,0,1852,1.0,10,4.0
2025-08-26T11:34:05.675183,0,1852,1.0,10,3.5
2025-08-26T11:34:06.175769,0,1852,1.0,10,4.0
2025-08-26T11:34:06.676378,0,1852,1.0,10,4.2
2025-08-26T11:34:07.176956,0,1852,1.0,10,3.6
2025-08-26T11:34:07.677511,0,1852,1.0,10,4.6
2025-08-26T11:34:08.178084,0,1852,1.0,10,7.1
2025-08-26T11:34:08.678703,0,1852,1.0,10,5.1
2025-08-26T11:34:09.179090,0,1852,1.0,10,3.7
2025-08-26T11:34:09.679389,0,1852,1.0,10,3.9
2025-08-26T11:34:10.179728,0,1852,1.0,10,3.5
2025-08-26T11:34:10.680055,0,1852,1.0,10,3.7
2025-08-26T11:34:11.180470,0,1852,1.0,10,4.3
2025-08-26T11:34:11.680807,0,1852,1.0,10,3.9
2025-08-26T11:34:12.181164,0,1852,1.0,10,4.0
2025-08-26T11:34:12.681454,0,1852,1.0,10,4.2
2025-08-26T11:34:13.181758,0,1852,1.0,10,4.2
2025-08-26T11:34:13.682362,0,1852,1.0,10,4.7
2025-08-26T11:34:14.182951,0,1852,1.0,10,4.0
2025-08-26T11:34:14.683551,0,1852,1.0,10,4.9
2025-08-26T11:34:15.184268,0,1852,1.0,10,3.6
2025-08-26T11:34:15.684933,0,1852,1.0,10,3.6
2025-08-26T11:34:16.185639,0,1852,1.0,10,3.3
2025-08-26T11:34:16.686387,0,1852,1.0,10,3.6
2025-08-26T11:34:17.187195,0,1852,1.0,10,4.6
2025-08-26T11:34:17.687572,0,1852,1.0,10,4.7
2025-08-26T11:34:18.188029,0,1852,1.0,10,3.5
2025-08-26T11:34:18.688372,0,1852,1.0,10,4.0
2025-08-26T11:34:19.188662,0,1852,1.0,10,5.7
2025-08-26T11:34:19.688949,0,1852,1.0,10,3.6
2025-08-26T11:34:20.189224,0,1852,1.0,10,3.3
2025-08-26T11:34:20.689532,0,1852,1.0,10,4.0
2025-08-26T11:34:21.189799,0,1852,1.0,10,3.3
2025-08-26T11:34:21.690051,0,1852,1.0,10,3.3
2025-08-26T11:34:22.190272,0,1852,1.0,10,3.4
2025-08-26T11:34:22.690526,0,1852,1.0,10,3.1
2025-08-26T11:34:23.191058,0,1852,1.0,10,3.0
2025-08-26T11:34:23.691687,0,1852,1.0,10,3.1
2025-08-26T11:34:24.192294,0,1852,1.0,10,3.5
2025-08-26T11:34:24.692839,0,1852,1.0,10,3.8
2025-08-26T11:34:25.193433,0,1852,1.0,10,4.2
2025-08-26T11:34:25.694052,0,1852,1.0,10,4.0
2025-08-26T11:34:26.194729,0,1852,1.0,10,3.6
2025-08-26T11:34:26.695050,0,1852,1.0,10,4.0
2025-08-26T11:34:27.195655,0,1852,1.0,10,3.8
2025-08-26T11:34:27.696020,0,1852,1.0,10,3.9
2025-08-26T11:34:28.196253,0,1852,1.0,10,4.2
2025-08-26T11:34:28.696504,0,1852,1.0,10,3.8
2025-08-26T11:34:29.196768,0,1852,1.0,10,3.5
2025-08-26T11:34:29.697022,0,1852,1.0,10,6.2
2025-08-26T11:34:30.197244,0,1852,1.0,10,3.8
2025-08-26T11:34:30.697528,0,1852,1.0,10,5.0
2025-08-26T11:34:31.197863,0,1852,1.0,10,4.1
2025-08-26T11:34:31.698223,0,1852,1.0,10,3.3
2025-08-26T11:34:32.198472,0,1852,1.0,10,3.6
2025-08-26T11:34:32.698718,0,1852,1.0,10,6.7
2025-08-26T11:34:33.199030,0,1852,1.0,10,3.5
2025-08-26T11:34:33.699253,0,1852,1.0,10,5.2
2025-08-26T11:34:34.199739,0,1852,1.0,10,3.2
2025-08-26T11:34:34.700475,0,1852,1.0,10,4.8
2025-08-26T11:34:35.200936,0,1852,1.0,10,4.0
2025-08-26T11:34:35.701494,0,1852,1.0,10,4.6
2025-08-26T11:34:36.202209,0,1852,1.0,10,3.9
2025-08-26T11:34:36.702809,0,1852,1.0,10,4.7
2025-08-26T11:34:37.203477,0,1852,1.0,10,4.2
2025-08-26T11:34:37.704055,0,1852,1.0,10,6.4
2025-08-26T11:34:38.204754,0,1852,1.0,10,5.2
2025-08-26T11:34:38.705349,0,1852,1.0,10,3.8
2025-08-26T11:34:39.205632,0,1852,1.0,10,4.8
2025-08-26T11:34:39.705858,0,1852,1.0,10,4.3
2025-08-26T11:34:40.206098,0,1852,1.0,10,4.6
2025-08-26T11:34:40.706370,0,1852,1.0,10,4.4
2025-08-26T11:34:41.206607,0,1852,1.0,10,3.2
2025-08-26T11:34:41.706853,0,1852,1.0,10,3.6
2025-08-26T11:34:42.207082,0,1852,1.0,10,6.5
2025-08-26T11:34:42.707324,0,1852,1.0,10,4.2
2025-08-26T11:34:43.207539,0,1852,1.0,10,4.3
2025-08-26T11:34:43.707821,0,1852,1.0,10,6.1
2025-08-26T11:34:44.208408,0,1852,1.0,10,3.4
2025-08-26T11:34:44.709039,0,1852,1.0,10,5.2
2025-08-26T11:34:45.209629,0,1852,1.0,10,5.7
2025-08-26T11:34:45.710381,0,1852,1.0,10,5.1
2025-08-26T11:34:46.211053,0,1852,1.0,10,4.6
2025-08-26T11:34:46.711645,0,1852,1.0,10,4.7
2025-08-26T11:34:47.212241,0,1852,1.0,10,3.9
2025-08-26T11:34:47.712924,0,1852,1.0,10,4.5
2025-08-26T11:34:48.213495,0,1852,1.0,10,4.0
2025-08-26T11:34:48.714083,0,1852,1.0,10,3.6
2025-08-26T11:34:49.214376,0,1852,1.0,10,5.3
2025-08-26T11:34:49.714660,0,1852,1.0,10,4.2
2025-08-26T11:34:50.214941,0,1852,1.0,10,3.1
2025-08-26T11:34:50.715227,0,1852,1.0,10,3.1
2025-08-26T11:34:51.215464,0,1852,1.0,10,2.9
2025-08-26T11:34:51.715690,0,1852,1.0,10,4.2
2025-08-26T11:34:52.216183,0,1852,1.0,10,3.5
2025-08-26T11:34:52.716492,0,1852,1.0,10,7.0
2025-08-26T11:34:53.216994,0,1852,1.0,10,3.7
2025-08-26T11:34:53.717504,0,1852,1.0,10,4.5
2025-08-26T11:34:54.218029,0,1852,1.0,10,4.4
2025-08-26T11:34:54.718607,0,1852,1.0,10,3.9
2025-08-26T11:34:55.219238,0,1852,1.0,10,4.2
2025-08-26T11:34:55.719850,0,1852,1.0,10,5.5
2025-08-26T11:34:56.220536,0,1852,1.0,10,6.9
2025-08-26T11:34:56.721129,0,1852,1.0,10,4.8
2025-08-26T11:34:57.221573,0,1852,1.0,10,4.6
2025-08-26T11:34:57.721847,0,1852,1.0,10,4.5
2025-08-26T11:34:58.222138,0,1852,1.0,10,3.9
2025-08-26T11:34:58.722391,0,1852,1.0,10,5.3
2025-08-26T11:34:59.222655,0,1852,1.0,10,4.4
2025-08-26T11:34:59.722901,0,1852,1.0,10,3.0
2025-08-26T11:35:00.223153,0,1852,1.0,10,3.9
2025-08-26T11:35:00.723411,0,1852,1.0,10,6.9
2025-08-26T11:35:01.223656,0,1852,1.0,10,4.5
2025-08-26T11:35:01.724269,0,1852,1.0,10,4.7
2025-08-26T11:35:02.224936,0,1852,1.0,10,4.0
2025-08-26T11:35:02.725371,0,1852,1.0,10,6.9
2025-08-26T11:35:03.225942,0,1852,1.0,10,4.6
2025-08-26T11:35:03.726551,0,1852,1.0,10,4.5
2025-08-26T11:35:04.227258,0,1852,1.0,10,4.4
2025-08-26T11:35:04.727969,0,1852,1.0,10,4.6
2025-08-26T11:35:05.228305,0,1852,1.0,10,3.6
2025-08-26T11:35:05.728814,0,1852,1.0,10,4.7
2025-08-26T11:35:06.229191,0,1852,1.0,10,5.6
2025-08-26T11:35:06.729449,0,1852,1.0,10,5.8
2025-08-26T11:35:07.229853,0,1852,1.0,10,4.1
2025-08-26T11:35:07.730135,0,1852,1.0,10,4.4
2025-08-26T11:35:08.230383,0,1852,1.0,10,6.6
2025-08-26T11:35:08.730645,0,1852,1.0,10,4.5
2025-08-26T11:35:09.230939,0,1852,1.0,10,4.7
2025-08-26T11:35:09.731195,0,1852,1.0,10,4.4
2025-08-26T11:35:10.231440,0,1852,1.0,10,5.5
2025-08-26T11:35:10.731716,0,1852,1.0,10,5.3
2025-08-26T11:35:11.232094,0,1852,1.0,10,4.4
2025-08-26T11:35:11.732417,0,1852,1.0,10,3.4
2025-08-26T11:35:12.232721,0,1852,1.0,10,5.7
2025-08-26T11:35:12.733440,0,1852,1.0,10,5.0
2025-08-26T11:35:13.234295,0,1852,1.0,10,5.1
2025-08-26T11:35:13.735262,0,1852,1.0,10,3.4
2025-08-26T11:35:14.236088,0,1852,1.0,10,3.6
2025-08-26T11:35:14.736890,0,1852,1.0,10,3.4
2025-08-26T11:35:15.237433,0,1852,1.0,10,3.3
2025-08-26T11:35:15.737991,0,1852,1.0,10,3.5
2025-08-26T11:35:16.238519,0,1852,1.0,10,3.3
2025-08-26T11:35:16.738817,0,1852,1.0,10,7.3
2025-08-26T11:35:17.239541,0,1852,1.0,10,5.1
2025-08-26T11:35:17.739897,0,1852,1.0,10,4.6
2025-08-26T11:35:18.240260,0,1852,1.0,10,6.2
2025-08-26T11:35:18.740513,0,1852,1.0,10,4.8
2025-08-26T11:35:19.240742,0,1852,1.0,10,4.8
2025-08-26T11:35:19.741136,0,1852,1.0,10,4.8
2025-08-26T11:35:20.241532,0,1852,1.0,10,5.6
2025-08-26T11:35:20.741974,0,1852,1.0,10,3.8
2025-08-26T11:35:21.242332,0,1852,1.0,10,4.8
2025-08-26T11:35:21.742660,0,1852,1.0,10,6.0
2025-08-26T11:35:22.242994,0,1852,1.0,10,4.8
2025-08-26T11:35:22.743271,0,1852,1.0,10,5.3
2025-08-26T11:35:23.243518,0,1852,1.0,10,3.7
2025-08-26T11:35:23.743989,0,1852,1.0,10,4.1
2025-08-26T11:35:24.244546,0,1852,1.0,10,4.5
2025-08-26T11:35:24.745114,0,1852,1.0,10,3.8
2025-08-26T11:35:25.245671,0,1852,1.0,10,4.5
2025-08-26T11:35:25.746404,0,1852,1.0,10,3.6
2025-08-26T11:35:26.246961,0,1852,1.0,10,4.8
2025-08-26T11:35:26.747249,0,1852,1.0,10,4.8
2025-08-26T11:35:27.247485,0,1852,1.0,10,5.4
2025-08-26T11:35:27.747716,0,1852,1.0,10,4.5
2025-08-26T11:35:28.247960,0,1852,1.0,10,4.0
2025-08-26T11:35:28.748205,0,1852,1.0,10,3.1
2025-08-26T11:35:29.248447,0,1852,1.0,10,3.3
2025-08-26T11:35:29.748687,0,1852,1.0,10,3.5
2025-08-26T11:35:30.248974,0,1852,1.0,10,3.9
2025-08-26T11:35:30.749263,0,1852,1.0,10,3.5
2025-08-26T11:35:31.249594,0,1852,1.0,10,3.7
2025-08-26T11:35:31.750303,0,1852,1.0,10,3.3
2025-08-26T11:35:32.250991,0,1852,1.0,10,3.4
2025-08-26T11:35:32.751738,0,1852,1.0,10,4.5
2025-08-26T11:35:33.252659,0,1852,1.0,10,3.9
2025-08-26T11:35:33.753318,0,1852,1.0,10,3.8
2025-08-26T11:35:34.253835,0,1852,1.0,10,3.8
2025-08-26T11:35:34.754566,0,1852,1.0,10,3.9
2025-08-26T11:35:35.254888,0,1852,1.0,10,5.7
2025-08-26T11:35:35.755419,0,1852,1.0,10,3.6
2025-08-26T11:35:36.255747,0,1852,1.0,10,6.8
2025-08-26T11:35:36.755981,0,1852,1.0,10,3.6
2025-08-26T11:35:37.256233,0,1852,1.0,10,3.7
2025-08-26T11:35:37.756484,0,1852,1.0,10,3.8
2025-08-26T11:35:38.256738,0,1852,1.0,10,4.5
2025-08-26T11:35:38.756993,0,1852,1.0,10,3.1
2025-08-26T11:35:39.257238,0,1852,1.0,10,3.5
2025-08-26T11:35:39.757830,0,1852,1.0,10,3.1
2025-08-26T11:35:40.258205,0,1852,1.0,10,4.0
2025-08-26T11:35:40.758778,0,1852,1.0,10,3.2
2025-08-26T11:35:41.259371,0,1852,1.0,10,3.8
2025-08-26T11:35:41.759930,0,1852,1.0,10,3.6
2025-08-26T11:35:42.260724,0,1852,1.0,10,3.3
2025-08-26T11:35:42.761313,0,1852,1.0,10,3.9
2025-08-26T11:35:43.261857,0,1852,1.0,10,3.5
2025-08-26T11:35:43.762456,0,1852,1.0,10,3.3
2025-08-26T11:35:44.263052,0,1852,1.0,10,3.3
2025-08-26T11:35:44.763680,0,1852,1.0,10,3.3
2025-08-26T11:35:45.264279,0,1852,1.0,10,3.6
2025-08-26T11:35:45.764894,0,1852,1.0,10,3.9
2025-08-26T11:35:46.265262,0,1852,1.0,10,4.1
2025-08-26T11:35:46.765500,0,1852,1.0,10,3.8
2025-08-26T11:35:47.265760,0,1852,1.0,10,3.3
2025-08-26T11:35:47.766016,0,1852,1.0,10,4.3
2025-08-26T11:35:48.266283,0,1852,1.0,10,5.5
2025-08-26T11:35:48.766519,0,1852,1.0,10,6.4
2025-08-26T11:35:49.266783,0,1852,1.0,10,3.9
2025-08-26T11:35:49.767069,0,1852,1.0,10,4.0
2025-08-26T11:35:50.267370,0,1852,1.0,10,4.2
2025-08-26T11:35:50.767607,0,1852,1.0,10,3.5
2025-08-26T11:35:51.268129,0,1852,1.0,10,5.5
2025-08-26T11:35:51.768710,0,1852,1.0,10,4.4
2025-08-26T11:35:52.269279,0,1852,1.0,10,3.5
2025-08-26T11:35:52.769534,0,1852,1.0,10,3.5
2025-08-26T11:35:53.270013,0,1852,1.0,10,3.8
2025-08-26T11:35:53.770597,0,1852,1.0,10,4.1
2025-08-26T11:35:54.271275,0,1852,1.0,10,3.5
2025-08-26T11:35:54.771868,0,1852,1.0,10,3.3
2025-08-26T11:35:55.272478,0,1852,1.0,10,3.4
2025-08-26T11:35:55.773033,0,1852,1.0,10,3.8
2025-08-26T11:35:56.273629,0,1852,1.0,10,6.5
2025-08-26T11:35:56.773953,0,1852,1.0,10,4.0
2025-08-26T11:35:57.274214,0,1852,1.0,10,4.6
2025-08-26T11:35:57.774640,0,1852,1.0,10,5.8
2025-08-26T11:35:58.275026,0,1852,1.0,10,3.1
2025-08-26T11:35:58.775307,0,1852,1.0,10,4.1
2025-08-26T11:35:59.275639,0,1852,1.0,10,4.8
2025-08-26T11:35:59.775966,0,1852,1.0,10,5.2
2025-08-26T11:36:00.276362,0,1852,1.0,10,4.1
2025-08-26T11:36:00.776621,0,1852,1.0,10,4.4
2025-08-26T11:36:01.276858,0,1852,1.0,10,3.5
2025-08-26T11:36:01.777114,0,1852,1.0,10,5.0
2025-08-26T11:36:02.277372,0,1852,1.0,10,3.3
2025-08-26T11:36:02.777723,0,1852,1.0,10,3.1
2025-08-26T11:36:03.278040,0,1852,1.0,10,3.5
2025-08-26T11:36:03.778259,0,1852,1.0,10,3.4
2025-08-26T11:36:04.278988,0,1852,1.0,10,3.3
2025-08-26T11:36:04.779586,0,1852,1.0,10,3.0
2025-08-26T11:36:05.280175,0,1852,1.0,10,3.3
2025-08-26T11:36:05.780753,0,1852,1.0,10,3.5
2025-08-26T11:36:06.281053,0,1852,1.0,10,3.9
2025-08-26T11:36:06.781508,0,1852,1.0,10,4.7
2025-08-26T11:36:07.282045,0,1852,1.0,10,4.6
2025-08-26T11:36:07.782586,0,1852,1.0,10,3.7
2025-08-26T11:36:08.283142,0,1852,1.0,10,3.6
2025-08-26T11:36:08.783796,0,1852,1.0,10,3.5
2025-08-26T11:36:09.284290,0,1852,1.0,10,3.6
2025-08-26T11:36:09.784645,0,1852,1.0,10,5.1
2025-08-26T11:36:10.284894,0,1852,1.0,10,4.1
2025-08-26T11:36:10.785189,0,1852,1.0,10,4.0
2025-08-26T11:36:11.285423,0,1852,1.0,10,3.0
2025-08-26T11:36:11.785638,0,1852,1.0,10,3.1
2025-08-26T11:36:12.285901,0,1852,1.0,10,5.5
2025-08-26T11:36:12.786234,0,1852,1.0,10,4.1
2025-08-26T11:36:13.286481,0,1852,1.0,10,8.0
2025-08-26T11:36:13.786765,0,1852,1.0,10,4.0
2025-08-26T11:36:14.287062,0,1852,1.0,10,3.3
2025-08-26T11:36:14.787313,0,1852,1.0,10,3.0
2025-08-26T11:36:15.287563,0,1852,1.0,10,3.0
2025-08-26T11:36:15.787839,0,1852,1.0,10,3.0
2025-08-26T11:36:16.288670,0,1852,1.0,10,3.1
2025-08-26T11:36:16.789168,0,1852,1.0,10,3.1
2025-08-26T11:36:17.289779,0,1852,1.0,10,7.0
2025-08-26T11:36:17.790319,0,1852,1.0,10,5.0
2025-08-26T11:36:18.290892,0,1852,1.0,10,4.7
2025-08-26T11:36:18.791453,0,1852,1.0,10,3.9
2025-08-26T11:36:19.292088,0,1852,1.0,10,5.6
2025-08-26T11:36:19.792626,0,1852,1.0,10,4.8
2025-08-26T11:36:20.293047,0,1852,1.0,10,4.5
2025-08-26T11:36:20.793355,0,1852,1.0,10,4.5
2025-08-26T11:36:21.293592,0,1852,1.0,10,4.5
2025-08-26T11:36:21.793848,0,1852,1.0,10,5.3
2025-08-26T11:36:22.294089,0,1852,1.0,10,4.4
2025-08-26T11:36:22.794303,0,1852,1.0,10,5.3
2025-08-26T11:36:23.294547,0,1852,1.0,10,3.6
2025-08-26T11:36:23.794797,0,1852,1.0,10,4.3
2025-08-26T11:36:24.295038,0,1852,1.0,10,4.1
2025-08-26T11:36:24.795242,0,1852,1.0,10,3.8
2025-08-26T11:36:25.295494,0,1852,1.0,10,4.1
2025-08-26T11:36:25.795811,0,1852,1.0,10,6.0
2025-08-26T11:36:26.296133,0,1852,1.0,10,3.7
2025-08-26T11:36:26.796430,0,1852,1.0,10,4.0
2025-08-26T11:36:27.297185,0,1852,1.0,10,3.6
2025-08-26T11:36:27.798076,0,1852,1.0,10,4.4
2025-08-26T11:36:28.298707,0,1852,1.0,10,3.8
2025-08-26T11:36:28.799150,0,1852,1.0,10,3.8
2025-08-26T11:36:29.299736,0,1852,1.0,10,5.8
2025-08-26T11:36:29.800391,0,1852,1.0,10,4.5
2025-08-26T11:36:30.301330,0,1852,1.0,10,4.9
2025-08-26T11:36:30.802294,0,1852,1.0,10,4.5
2025-08-26T11:36:31.302802,0,1852,1.0,10,4.1
2025-08-26T11:36:31.803197,0,1852,1.0,10,3.7
2025-08-26T11:36:32.303511,0,1852,1.0,10,3.3
2025-08-26T11:36:32.803823,0,1852,1.0,10,5.6
2025-08-26T11:36:33.304204,0,1852,1.0,10,5.2
2025-08-26T11:36:33.804511,0,1852,1.0,10,5.1
2025-08-26T11:36:34.305166,0,1852,1.0,10,4.5
2025-08-26T11:36:34.805585,0,1852,1.0,10,3.2
2025-08-26T11:36:35.305965,0,1852,1.0,10,3.8
2025-08-26T11:36:35.806298,0,1852,1.0,10,3.3
2025-08-26T11:36:36.307029,0,1852,1.0,10,5.2
2025-08-26T11:36:36.807826,0,1852,1.0,10,4.6
2025-08-26T11:36:37.308653,0,1852,1.0,10,5.1
2025-08-26T11:36:37.809529,0,1852,1.0,10,5.3
2025-08-26T11:36:38.310429,0,1852,1.0,10,5.1
2025-08-26T11:36:38.810979,0,1852,1.0,10,5.3
2025-08-26T11:36:39.311426,0,1852,1.0,10,5.3
2025-08-26T11:36:39.812188,0,1852,1.0,10,7.3
2025-08-26T11:36:40.313055,0,1852,1.0,10,4.8
2025-08-26T11:36:40.813560,0,1852,1.0,10,5.4
2025-08-26T11:36:41.313803,0,1852,1.0,10,4.2
2025-08-26T11:36:41.814042,0,1852,1.0,10,3.8
2025-08-26T11:36:42.314335,0,1852,1.0,10,3.2
2025-08-26T11:36:42.814637,0,1852,1.0,10,3.3
2025-08-26T11:36:43.314871,0,1852,1.0,10,4.0
2025-08-26T11:36:43.815122,0,1852,1.0,10,4.6
2025-08-26T11:36:44.315396,0,1852,1.0,10,5.1
2025-08-26T11:36:44.815625,0,1852,1.0,10,4.0
2025-08-26T11:36:45.315872,0,1852,1.0,10,3.0
2025-08-26T11:36:45.816094,0,1852,1.0,10,3.2
2025-08-26T11:36:46.316472,0,1852,1.0,10,3.4
2025-08-26T11:36:46.817032,0,1852,1.0,10,4.4
2025-08-26T11:36:47.317632,0,1852,1.0,10,3.6
2025-08-26T11:36:47.817936,0,1852,1.0,10,6.5
2025-08-26T11:36:48.318461,0,1852,1.0,10,4.8
2025-08-26T11:36:48.819132,0,1852,1.0,10,3.7
2025-08-26T11:36:49.319740,0,1852,1.0,10,3.8
2025-08-26T11:36:49.820384,0,1852,1.0,10,7.5
2025-08-26T11:36:50.320941,0,1852,1.0,10,4.0
2025-08-26T11:36:50.821499,0,1852,1.0,10,3.4
2025-08-26T11:36:51.321896,0,1852,1.0,10,4.8
2025-08-26T11:36:51.822449,0,1852,1.0,10,7.0
2025-08-26T11:36:52.322729,0,1852,1.0,10,5.2
2025-08-26T11:36:52.822979,0,1852,1.0,10,3.9
2025-08-26T11:36:53.323223,0,1852,1.0,10,4.0
2025-08-26T11:36:53.823446,0,1852,1.0,10,3.8
2025-08-26T11:36:54.323735,0,1852,1.0,10,4.2
2025-08-26T11:36:54.823972,0,1852,1.0,10,4.6
2025-08-26T11:36:55.324257,0,1852,1.0,10,4.6
2025-08-26T11:36:55.824481,0,1852,1.0,10,3.6
2025-08-26T11:36:56.324705,0,1852,1.0,10,3.2
2025-08-26T11:36:56.824928,0,1852,1.0,10,3.9
2025-08-26T11:36:57.325316,0,1852,1.0,10,3.6
2025-08-26T11:36:57.825807,0,1852,1.0,10,3.6
2025-08-26T11:36:58.326391,0,1852,1.0,10,4.1
2025-08-26T11:36:58.826957,0,1852,1.0,10,4.3
2025-08-26T11:36:59.327317,0,1852,1.0,10,6.6
2025-08-26T11:36:59.827792,0,1852,1.0,10,5.0
2025-08-26T11:37:00.328694,0,1852,1.0,10,4.6
2025-08-26T11:37:00.829558,0,1852,1.0,10,7.5
2025-08-26T11:37:01.330141,0,1852,1.0,10,5.0
2025-08-26T11:37:01.830748,0,1852,1.0,10,3.8
2025-08-26T11:37:02.331115,0,1852,1.0,10,3.7
2025-08-26T11:37:02.831419,0,1852,1.0,10,4.2
2025-08-26T11:37:03.331711,0,1852,1.0,10,3.7
2025-08-26T11:37:03.832014,0,1852,1.0,10,3.1
2025-08-26T11:37:04.332294,0,1852,1.0,10,3.7
2025-08-26T11:37:04.832523,0,1852,1.0,10,3.6
2025-08-26T11:37:05.332801,0,1852,1.0,10,3.3
2025-08-26T11:37:05.833028,0,1852,1.0,10,3.4
2025-08-26T11:37:06.333312,0,1852,1.0,10,3.7
2025-08-26T11:37:06.833539,0,1852,1.0,10,3.6
2025-08-26T11:37:07.333750,0,1852,1.0,10,3.1
2025-08-26T11:37:07.833992,0,1852,1.0,10,3.6
2025-08-26T11:37:08.334265,0,1852,1.0,10,3.5
2025-08-26T11:37:08.834669,0,1852,1.0,10,3.3
2025-08-26T11:37:09.335248,0,1852,1.0,10,3.9
2025-08-26T11:37:09.835799,0,1852,1.0,10,4.4
2025-08-26T11:37:10.336390,0,1852,1.0,10,3.6
2025-08-26T11:37:10.836835,0,1852,1.0,10,4.3
2025-08-26T11:37:11.337414,0,1852,1.0,10,4.5
2025-08-26T11:37:11.838020,0,1852,1.0,10,3.9
2025-08-26T11:37:12.338606,0,1852,1.0,10,3.4
2025-08-26T11:37:12.839222,0,1852,1.0,10,3.3
2025-08-26T11:37:13.339743,0,1852,1.0,10,4.0
2025-08-26T11:37:13.840071,0,1852,1.0,10,4.1
2025-08-26T11:37:14.340322,0,1852,1.0,10,3.3
2025-08-26T11:37:14.840591,0,1852,1.0,10,3.7
2025-08-26T11:37:15.340821,0,1852,1.0,10,3.4
2025-08-26T11:37:15.841074,0,1852,1.0,10,3.6
2025-08-26T11:37:16.341310,0,1852,1.0,10,3.3
2025-08-26T11:37:16.841573,0,1852,1.0,10,3.5
2025-08-26T11:37:17.341853,0,1852,1.0,10,3.7
2025-08-26T11:37:17.842132,0,1852,1.0,10,3.9
2025-08-26T11:37:18.342375,0,1852,1.0,10,4.2
2025-08-26T11:37:18.842606,0,1852,1.0,10,3.5
2025-08-26T11:37:19.343030,0,1852,1.0,10,4.0
2025-08-26T11:37:19.843580,0,1852,1.0,10,5.4
2025-08-26T11:37:20.344191,0,1852,1.0,10,4.1
2025-08-26T11:37:20.844773,0,1852,1.0,10,3.9
2025-08-26T11:37:21.345387,0,1852,1.0,10,3.6
2025-08-26T11:37:21.845944,0,1852,1.0,10,4.2
2025-08-26T11:37:22.346510,0,1852,1.0,10,3.8
2025-08-26T11:37:22.847156,0,1852,1.0,10,4.3
2025-08-26T11:37:23.348253,0,1852,1.0,10,4.1
2025-08-26T11:37:23.848872,0,1852,1.0,10,3.8
2025-08-26T11:37:24.349185,0,1852,1.0,10,4.7
2025-08-26T11:37:24.849588,0,1852,1.0,10,4.4
2025-08-26T11:37:25.349831,0,1852,1.0,10,4.5
2025-08-26T11:37:25.850127,0,1852,1.0,10,5.6
2025-08-26T11:37:26.350440,0,1852,1.0,10,3.1
2025-08-26T11:37:26.850729,0,1852,1.0,10,4.0
2025-08-26T11:37:27.350974,0,1852,1.0,10,4.0
2025-08-26T11:37:27.851284,0,1852,1.0,10,3.8
2025-08-26T11:37:28.351555,0,1852,1.0,10,3.8
2025-08-26T11:37:28.851805,0,1852,1.0,10,3.5
2025-08-26T11:37:29.352059,0,1852,1.0,10,3.4
2025-08-26T11:37:29.852596,0,1852,1.0,10,3.6
2025-08-26T11:37:30.353271,0,1852,1.0,10,3.2
2025-08-26T11:37:30.853850,0,1852,1.0,10,3.6
2025-08-26T11:37:31.354438,0,1852,1.0,10,3.4
2025-08-26T11:37:31.855024,0,1852,1.0,10,4.0
2025-08-26T11:37:32.355459,0,1852,1.0,10,3.7
2025-08-26T11:37:32.855945,0,1852,1.0,10,4.3
2025-08-26T11:37:33.356557,0,1852,1.0,10,5.3
2025-08-26T11:37:33.857158,0,1852,1.0,10,4.4
2025-08-26T11:37:34.357704,0,1852,1.0,10,5.0
2025-08-26T11:37:34.858040,0,1852,1.0,10,5.1
2025-08-26T11:37:35.358397,0,1852,1.0,10,4.5
2025-08-26T11:37:35.858728,0,1852,1.0,10,6.7
2025-08-26T11:37:36.359062,0,1852,1.0,10,3.9
2025-08-26T11:37:36.859400,0,1852,1.0,10,4.5
2025-08-26T11:37:37.359698,0,1852,1.0,10,5.0
2025-08-26T11:37:37.860026,0,1852,1.0,10,5.2
2025-08-26T11:37:38.360342,0,1852,1.0,10,5.0
2025-08-26T11:37:38.860738,0,1852,1.0,10,4.1
2025-08-26T11:37:39.361081,0,1852,1.0,10,3.0
2025-08-26T11:37:39.861836,0,1852,1.0,10,3.3
2025-08-26T11:37:40.362817,0,1852,1.0,10,3.1
2025-08-26T11:37:40.863415,0,1852,1.0,10,4.3
2025-08-26T11:37:41.363953,0,1852,1.0,10,4.6
2025-08-26T11:37:41.864549,0,1852,1.0,10,3.6
2025-08-26T11:37:42.365318,0,1852,1.0,10,3.8
2025-08-26T11:37:42.865895,0,1852,1.0,10,3.7
2025-08-26T11:37:43.366526,0,1852,1.0,10,3.6
2025-08-26T11:37:43.867162,0,1852,1.0,10,3.3
2025-08-26T11:37:44.367775,0,1852,1.0,10,3.6
2025-08-26T11:37:44.868425,0,1852,1.0,10,3.6
2025-08-26T11:37:45.368734,0,1852,1.0,10,3.6
2025-08-26T11:37:45.868984,0,1852,1.0,10,4.3
2025-08-26T11:37:46.369281,0,1852,1.0,10,3.1
2025-08-26T11:37:46.869579,0,1852,1.0,10,3.6
2025-08-26T11:37:47.369850,0,1852,1.0,10,2.9
2025-08-26T11:37:47.870113,0,1852,1.0,10,6.4
2025-08-26T11:37:48.370381,0,1852,1.0,10,4.0
2025-08-26T11:37:48.870633,0,1852,1.0,10,3.4
2025-08-26T11:37:49.370873,0,1852,1.0,10,3.7
2025-08-26T11:37:49.871120,0,1852,1.0,10,5.2
2025-08-26T11:37:50.371648,0,1852,1.0,10,4.6
2025-08-26T11:37:50.872308,0,1852,1.0,10,4.6
2025-08-26T11:37:51.372891,0,1852,1.0,10,4.5
2025-08-26T11:37:51.873558,0,1852,1.0,10,4.0
2025-08-26T11:37:52.373882,0,1852,1.0,10,4.5
2025-08-26T11:37:52.874455,0,1852,1.0,10,3.7
2025-08-26T11:37:53.375081,0,1852,1.0,10,4.2
2025-08-26T11:37:53.875779,0,1852,1.0,10,4.0
2025-08-26T11:37:54.376315,0,1852,1.0,10,3.7
2025-08-26T11:37:54.876692,0,1852,1.0,10,5.7
2025-08-26T11:37:55.376979,0,1852,1.0,10,3.9
2025-08-26T11:37:55.877236,0,1852,1.0,10,4.1
2025-08-26T11:37:56.377511,0,1852,1.0,10,6.3
2025-08-26T11:37:56.877788,0,1852,1.0,10,3.5
2025-08-26T11:37:57.378068,0,1852,1.0,10,3.1
2025-08-26T11:37:57.878336,0,1852,1.0,10,2.9
2025-08-26T11:37:58.378586,0,1852,1.0,10,3.1
2025-08-26T11:37:58.878849,0,1852,1.0,10,3.0
2025-08-26T11:37:59.379242,0,1852,1.0,10,3.2
2025-08-26T11:37:59.879720,0,1852,1.0,10,2.9
2025-08-26T11:38:00.380521,0,1852,1.0,10,3.0
2025-08-26T11:38:00.881405,0,1852,1.0,10,3.3
2025-08-26T11:38:01.382407,0,1852,1.0,10,3.1
2025-08-26T11:38:01.883011,0,1852,1.0,10,5.0
2025-08-26T11:38:02.383350,0,1852,1.0,10,4.7
2025-08-26T11:38:02.883912,0,1852,1.0,10,3.8
2025-08-26T11:38:03.384550,0,1852,1.0,10,3.8
2025-08-26T11:38:03.885180,0,1852,1.0,10,3.4
2025-08-26T11:38:04.385810,0,1852,1.0,10,3.1
2025-08-26T11:38:04.886574,0,1852,1.0,10,3.2
2025-08-26T11:38:05.387513,0,1852,1.0,10,3.6
2025-08-26T11:38:05.888485,0,1852,1.0,10,3.1
2025-08-26T11:38:06.389186,0,1852,1.0,10,3.2
2025-08-26T11:38:06.889585,0,1852,1.0,10,3.5
2025-08-26T11:38:07.390010,0,1852,1.0,10,3.4
2025-08-26T11:38:07.890538,0,1852,1.0,10,4.3
2025-08-26T11:38:08.391041,0,1852,1.0,10,4.0
2025-08-26T11:38:08.891375,0,1852,1.0,10,4.1
2025-08-26T11:38:09.391720,0,1852,1.0,10,3.1
2025-08-26T11:38:09.893264,0,1852,1.0,10,3.3
2025-08-26T11:38:10.393661,0,1852,1.0,10,3.0
2025-08-26T11:38:10.894041,0,1852,1.0,10,3.3
2025-08-26T11:38:11.394393,0,1852,1.0,10,3.1
2025-08-26T11:38:11.894727,0,1852,1.0,10,3.1
2025-08-26T11:38:12.395038,0,1852,1.0,10,2.9
2025-08-26T11:38:12.895664,0,1852,1.0,10,3.3
2025-08-26T11:38:13.396317,0,1852,1.0,10,3.8
2025-08-26T11:38:13.896920,0,1852,1.0,10,3.4
2025-08-26T11:38:14.397537,0,1852,1.0,10,3.1
2025-08-26T11:38:14.898271,0,1852,1.0,10,3.2
2025-08-26T11:38:15.398838,0,1852,1.0,10,3.3
2025-08-26T11:38:15.899455,0,1852,1.0,10,3.4
2025-08-26T11:38:16.400028,0,1852,1.0,10,3.4
2025-08-26T11:38:16.900596,0,1852,1.0,10,3.1
2025-08-26T11:38:17.401183,0,1852,1.0,10,3.3
2025-08-26T11:38:17.901783,0,1852,1.0,10,3.1
2025-08-26T11:38:18.402380,0,1852,1.0,10,3.2
2025-08-26T11:38:18.902937,0,1852,1.0,10,3.0
2025-08-26T11:38:19.403523,0,1852,1.0,10,3.0
2025-08-26T11:38:19.904129,0,1852,1.0,10,3.4
2025-08-26T11:38:20.404513,0,1852,1.0,10,3.2
2025-08-26T11:38:20.904819,0,1852,1.0,10,3.1
2025-08-26T11:38:21.405073,0,1852,1.0,10,3.0
2025-08-26T11:38:21.905352,0,1852,1.0,10,3.0
2025-08-26T11:38:22.405604,0,1852,1.0,10,2.9
2025-08-26T11:38:22.905900,0,1852,1.0,10,3.1
2025-08-26T11:38:23.406209,0,1852,1.0,10,3.3
2025-08-26T11:38:23.906527,0,1852,1.0,10,3.3
2025-08-26T11:38:24.407012,0,1852,1.0,10,3.4
2025-08-26T11:38:24.907556,0,1852,1.0,10,3.0
2025-08-26T11:38:25.408143,0,1852,1.0,10,3.5
2025-08-26T11:38:25.908827,0,1852,1.0,10,3.5
2025-08-26T11:38:26.409478,0,1852,1.0,10,3.4
2025-08-26T11:38:26.910089,0,1852,1.0,10,3.4
2025-08-26T11:38:27.410766,0,1852,1.0,10,3.3
2025-08-26T11:38:27.911705,0,1852,1.0,10,4.5
2025-08-26T11:38:28.412721,0,1852,1.0,10,4.0
2025-08-26T11:38:28.913877,0,1852,1.0,10,4.0
2025-08-26T11:38:29.414304,0,1852,1.0,10,4.1
2025-08-26T11:38:29.914617,0,1852,1.0,10,4.7
2025-08-26T11:38:30.414960,0,1852,1.0,10,3.8
2025-08-26T11:38:30.915429,0,1852,1.0,10,3.8
2025-08-26T11:38:31.415768,0,1852,1.0,10,3.5
2025-08-26T11:38:31.916123,0,1852,1.0,10,4.9
2025-08-26T11:38:32.416384,0,1852,1.0,10,4.0
2025-08-26T11:38:32.916624,0,1852,1.0,10,3.6
2025-08-26T11:38:33.416888,0,1852,1.0,10,5.1
2025-08-26T11:38:33.917571,0,1852,1.0,10,3.1
2025-08-26T11:38:34.418125,0,1852,1.0,10,3.6
2025-08-26T11:38:34.918704,0,1852,1.0,10,3.5
2025-08-26T11:38:35.419318,0,1852,1.0,10,3.7
2025-08-26T11:38:35.919918,0,1852,1.0,10,3.9
2025-08-26T11:38:36.420880,0,1852,1.0,10,3.6
2025-08-26T11:38:36.921985,0,1852,1.0,10,3.4
2025-08-26T11:38:37.422669,0,1852,1.0,10,3.4
2025-08-26T11:38:37.923273,0,1852,1.0,10,3.6
2025-08-26T11:38:38.423615,0,1852,1.0,10,3.6
2025-08-26T11:38:38.923874,0,1852,1.0,10,3.3
2025-08-26T11:38:39.424132,0,1852,1.0,10,3.3
2025-08-26T11:38:39.924383,0,1852,1.0,10,3.9
2025-08-26T11:38:40.424636,0,1852,1.0,10,3.5
2025-08-26T11:38:40.924880,0,1852,1.0,10,3.4
2025-08-26T11:38:41.425134,0,1852,1.0,10,3.3
2025-08-26T11:38:41.925389,0,1852,1.0,10,3.2
2025-08-26T11:38:42.425645,0,1852,1.0,10,3.2
2025-08-26T11:38:42.925893,0,1852,1.0,10,3.8
2025-08-26T11:38:43.426608,0,1852,1.0,10,3.3
2025-08-26T11:38:43.927322,0,1852,1.0,10,3.2
2025-08-26T11:38:44.427955,0,1852,1.0,10,3.8
2025-08-26T11:38:44.928547,0,1852,1.0,10,4.0
2025-08-26T11:38:45.429185,0,1852,1.0,10,3.8
2025-08-26T11:38:45.929676,0,1852,1.0,10,4.0
2025-08-26T11:38:46.430345,0,1852,1.0,10,3.9
2025-08-26T11:38:46.930708,0,1852,1.0,10,4.8
2025-08-26T11:38:47.431279,0,1852,1.0,10,4.0
2025-08-26T11:38:47.931879,0,1852,1.0,10,3.8
2025-08-26T11:38:48.432186,0,1852,1.0,10,3.5
2025-08-26T11:38:48.932475,0,1852,1.0,10,3.4
2025-08-26T11:38:49.432737,0,1852,1.0,10,3.4
2025-08-26T11:38:49.932993,0,1852,1.0,10,3.1
2025-08-26T11:38:50.433246,0,1852,1.0,10,3.1
2025-08-26T11:38:50.933505,0,1852,1.0,10,2.9
2025-08-26T11:38:51.433767,0,1852,1.0,10,3.5
2025-08-26T11:38:51.934011,0,1852,1.0,10,4.4
2025-08-26T11:38:52.434428,0,1852,1.0,10,4.7
2025-08-26T11:38:52.934967,0,1852,1.0,10,4.0
2025-08-26T11:38:53.435652,0,1852,1.0,10,4.5
2025-08-26T11:38:53.936273,0,1852,1.0,10,3.5
2025-08-26T11:38:54.436884,0,1852,1.0,10,3.8
2025-08-26T11:38:54.937235,0,1852,1.0,10,4.1
2025-08-26T11:38:55.437548,0,1852,1.0,10,6.5
2025-08-26T11:38:55.937949,0,1852,1.0,10,5.1
2025-08-26T11:38:56.438448,0,1852,1.0,10,5.0
2025-08-26T11:38:56.938929,0,1852,1.0,10,4.1
2025-08-26T11:38:57.439255,0,1852,1.0,10,4.5
2025-08-26T11:38:57.939508,0,1852,1.0,10,4.6
2025-08-26T11:38:58.439817,0,1852,1.0,10,4.1
2025-08-26T11:38:58.940132,0,1852,1.0,10,3.7
2025-08-26T11:38:59.440379,0,1852,1.0,10,3.9
2025-08-26T11:38:59.940635,0,1852,1.0,10,4.0
2025-08-26T11:39:00.440885,0,1852,1.0,10,3.4
2025-08-26T11:39:00.941211,0,1852,1.0,10,3.3
2025-08-26T11:39:01.441499,0,1852,1.0,10,3.3
2025-08-26T11:39:01.941758,0,1852,1.0,10,3.2
2025-08-26T11:39:02.442009,0,1852,1.0,10,3.3
2025-08-26T11:39:02.942620,0,1852,1.0,10,4.8
2025-08-26T11:39:03.443265,0,1852,1.0,10,3.5
2025-08-26T11:39:03.943854,0,1852,1.0,10,3.3
2025-08-26T11:39:04.444393,0,1852,1.0,10,3.8
2025-08-26T11:39:04.944937,0,1852,1.0,10,4.3
2025-08-26T11:39:05.445516,0,1852,1.0,10,4.4
2025-08-26T11:39:05.946140,0,1852,1.0,10,3.6
2025-08-26T11:39:06.446464,0,1852,1.0,10,4.4
2025-08-26T11:39:06.946689,0,1852,1.0,10,3.8
2025-08-26T11:39:07.446941,0,1852,1.0,10,3.8
2025-08-26T11:39:07.947227,0,1852,1.0,10,4.1
2025-08-26T11:39:08.447474,0,1852,1.0,10,4.5
2025-08-26T11:39:08.947732,0,1852,1.0,10,3.4
2025-08-26T11:39:09.448001,0,1852,1.0,10,4.7
2025-08-26T11:39:09.948293,0,1852,1.0,10,5.4
2025-08-26T11:39:10.448918,0,1852,1.0,10,6.2
2025-08-26T11:39:10.949538,0,1852,1.0,10,3.7
2025-08-26T11:39:11.450194,0,1852,1.0,10,3.6
2025-08-26T11:39:11.950791,0,1852,1.0,10,5.0
2025-08-26T11:39:12.451574,0,1852,1.0,10,5.8
2025-08-26T11:39:12.952033,0,1852,1.0,10,5.1
2025-08-26T11:39:13.452366,0,1852,1.0,10,4.8
2025-08-26T11:39:13.952633,0,1852,1.0,10,4.8
2025-08-26T11:39:14.452969,0,1852,1.0,10,5.8
2025-08-26T11:39:14.953240,0,1852,1.0,10,3.6
2025-08-26T11:39:15.453512,0,1852,1.0,10,5.7
2025-08-26T11:39:15.953775,0,1852,1.0,10,4.4
2025-08-26T11:39:16.454094,0,1852,1.0,10,3.8
2025-08-26T11:39:16.954513,0,1852,1.0,10,3.5
2025-08-26T11:39:17.454792,0,1852,1.0,10,3.6
2025-08-26T11:39:17.955142,0,1852,1.0,10,6.7
2025-08-26T11:39:18.455424,0,1852,1.0,10,4.8
2025-08-26T11:39:18.956042,0,1852,1.0,10,3.5
2025-08-26T11:39:19.456643,0,1852,1.0,10,3.8
2025-08-26T11:39:19.957141,0,1852,1.0,10,5.1
2025-08-26T11:39:20.457487,0,1852,1.0,10,5.2
2025-08-26T11:39:20.957882,0,1852,1.0,10,4.9
2025-08-26T11:39:21.458441,0,1852,1.0,10,5.8
2025-08-26T11:39:21.959019,0,1852,1.0,10,7.3
2025-08-26T11:39:22.459619,0,1852,1.0,10,5.6
2025-08-26T11:39:22.960012,0,1852,1.0,10,4.5
2025-08-26T11:39:23.460284,0,1852,1.0,10,4.5
2025-08-26T11:39:23.960574,0,1852,1.0,10,4.3
2025-08-26T11:39:24.460872,0,1852,1.0,10,5.0
2025-08-26T11:39:24.961169,0,1852,1.0,10,5.0
2025-08-26T11:39:25.461459,0,1852,1.0,10,5.2
2025-08-26T11:39:25.961758,0,1852,1.0,10,4.6
2025-08-26T11:39:26.462015,0,1852,1.0,10,4.1
2025-08-26T11:39:26.962259,0,1852,1.0,10,6.8
2025-08-26T11:39:27.462505,0,1852,1.0,10,5.6
2025-08-26T11:39:27.962751,0,1852,1.0,10,4.8
2025-08-26T11:39:28.463000,0,1852,1.0,10,4.4
2025-08-26T11:39:28.963271,0,1852,1.0,10,3.9
2025-08-26T11:39:29.463520,0,1852,1.0,10,4.5
2025-08-26T11:39:29.963809,0,1852,1.0,10,3.6
2025-08-26T11:39:30.464126,0,1852,1.0,10,3.5
2025-08-26T11:39:30.964444,0,1852,1.0,10,3.6
2025-08-26T11:39:31.464732,0,1852,1.0,10,3.4
2025-08-26T11:39:31.964997,0,1852,1.0,10,3.1
2025-08-26T11:39:32.465293,0,1852,1.0,10,3.5
2025-08-26T11:39:32.965606,0,1852,1.0,10,3.3
2025-08-26T11:39:33.466035,0,1852,1.0,10,4.6
2025-08-26T11:39:33.966611,0,1852,1.0,10,5.4
2025-08-26T11:39:34.467311,0,1852,1.0,10,6.6
2025-08-26T11:39:34.967891,0,1852,1.0,10,5.0
2025-08-26T11:39:35.468560,0,1852,1.0,10,4.1
2025-08-26T11:39:35.969173,0,1852,1.0,10,4.3
2025-08-26T11:39:36.469840,0,1852,1.0,10,4.8
2025-08-26T11:39:36.970446,0,1852,1.0,10,4.0
2025-08-26T11:39:37.471028,0,1852,1.0,10,4.6
2025-08-26T11:39:37.971744,0,1852,1.0,10,4.3
2025-08-26T11:39:38.472458,0,1852,1.0,10,3.5
2025-08-26T11:39:38.973219,0,1852,1.0,10,3.6
2025-08-26T11:39:39.473549,0,1852,1.0,10,3.8
2025-08-26T11:39:39.973829,0,1852,1.0,10,3.4
2025-08-26T11:39:40.474080,0,1852,1.0,10,3.5
2025-08-26T11:39:40.974326,0,1852,1.0,10,3.5
2025-08-26T11:39:41.474571,0,1852,1.0,10,3.5
2025-08-26T11:39:41.974822,0,1852,1.0,10,3.4
2025-08-26T11:39:42.475121,0,1852,1.0,10,3.5
2025-08-26T11:39:42.975377,0,1852,1.0,10,3.3
2025-08-26T11:39:43.475686,0,1852,1.0,10,3.6
2025-08-26T11:39:43.975936,0,1852,1.0,10,3.3
2025-08-26T11:39:44.476492,0,1852,1.0,10,3.3
2025-08-26T11:39:44.977128,0,1852,1.0,10,3.6
2025-08-26T11:39:45.477727,0,1852,1.0,10,3.5
2025-08-26T11:39:45.978413,0,1852,1.0,10,3.6
2025-08-26T11:39:46.479127,0,1852,1.0,10,3.5
2025-08-26T11:39:46.979753,0,1852,1.0,10,3.9
2025-08-26T11:39:47.480455,0,1852,1.0,10,3.4
2025-08-26T11:39:47.980775,0,1852,1.0,10,4.1
2025-08-26T11:39:48.481498,0,1852,1.0,10,5.5
2025-08-26T11:39:48.982174,0,1852,1.0,10,4.9
2025-08-26T11:39:49.482666,0,1852,1.0,10,3.6
2025-08-26T11:39:49.982983,0,1852,1.0,10,4.1
2025-08-26T11:39:50.483238,0,1852,1.0,10,4.3
2025-08-26T11:39:50.983471,0,1852,1.0,10,4.1
2025-08-26T11:39:51.483734,0,1852,1.0,10,4.3
2025-08-26T11:39:51.983976,0,1852,1.0,10,5.4
2025-08-26T11:39:52.484238,0,1852,1.0,10,5.3
2025-08-26T11:39:52.984540,0,1852,1.0,10,3.5
2025-08-26T11:39:53.484807,0,1852,1.0,10,8.0
2025-08-26T11:39:53.985059,0,1852,1.0,10,3.7
2025-08-26T11:39:54.485276,0,1852,1.0,10,4.6
2025-08-26T11:39:54.985633,0,1852,1.0,10,6.1
2025-08-26T11:39:55.486019,0,1852,1.0,10,3.8
2025-08-26T11:39:55.986525,0,1852,1.0,10,4.8
2025-08-26T11:39:56.487217,0,1852,1.0,10,4.7
2025-08-26T11:39:56.987875,0,1852,1.0,10,4.3
2025-08-26T11:39:57.488493,0,1852,1.0,10,5.7
2025-08-26T11:39:57.989069,0,1852,1.0,10,5.2
2025-08-26T11:39:58.489607,0,1852,1.0,10,5.2
2025-08-26T11:39:58.990167,0,1852,1.0,10,4.8
2025-08-26T11:39:59.490685,0,1852,1.0,10,3.7
2025-08-26T11:39:59.991161,0,1852,1.0,10,5.7
2025-08-26T11:40:00.491802,0,1852,1.0,10,4.9
2025-08-26T11:40:00.992225,0,1852,1.0,10,3.3
2025-08-26T11:40:01.492507,0,1852,1.0,10,4.8
2025-08-26T11:40:01.992739,0,1852,1.0,10,3.1
2025-08-26T11:40:02.493187,0,1852,1.0,10,3.4
2025-08-26T11:40:02.993477,0,1852,1.0,10,4.1
2025-08-26T11:40:03.493766,0,1852,1.0,10,4.6
2025-08-26T11:40:03.994055,0,1852,1.0,10,3.8
2025-08-26T11:40:04.494277,0,1852,1.0,10,3.3
2025-08-26T11:40:04.994518,0,1852,1.0,10,3.1
2025-08-26T11:40:05.494762,0,1852,1.0,10,5.6
2025-08-26T11:40:05.995005,0,1852,1.0,10,4.6
2025-08-26T11:40:06.495258,0,1852,1.0,10,4.8
2025-08-26T11:40:06.995507,0,1852,1.0,10,4.3
2025-08-26T11:40:07.495757,0,1852,1.0,10,4.3
2025-08-26T11:40:07.996024,0,1852,1.0,10,3.6
2025-08-26T11:40:08.496311,0,1852,1.0,10,3.7
2025-08-26T11:40:08.996562,0,1852,1.0,10,3.7
2025-08-26T11:40:09.497143,0,1852,1.0,10,4.2
2025-08-26T11:40:09.997592,0,1852,1.0,10,4.0
2025-08-26T11:40:10.498168,0,1852,1.0,10,4.0
2025-08-26T11:40:10.998619,0,1852,1.0,10,5.0
2025-08-26T11:40:11.499185,0,1852,1.0,10,5.8
2025-08-26T11:40:11.999739,0,1852,1.0,10,3.6
2025-08-26T11:40:12.500344,0,1852,1.0,10,3.5
2025-08-26T11:40:13.000914,0,1852,1.0,10,3.4
2025-08-26T11:40:13.501387,0,1852,1.0,10,3.3
2025-08-26T11:40:14.001704,0,1852,1.0,10,3.1
2025-08-26T11:40:14.502023,0,1852,1.0,10,3.1
2025-08-26T11:40:15.002245,0,1852,1.0,10,3.4
2025-08-26T11:40:15.502485,0,1852,1.0,10,3.3
2025-08-26T11:40:16.002707,0,1852,1.0,10,3.8
2025-08-26T11:40:16.502958,0,1852,1.0,10,4.1
2025-08-26T11:40:17.003252,0,1852,1.0,10,5.4
2025-08-26T11:40:17.503592,0,1852,1.0,10,4.1
2025-08-26T11:40:18.003891,0,1852,1.0,10,4.0
2025-08-26T11:40:18.504318,0,1852,1.0,10,3.9
2025-08-26T11:40:19.005147,0,1852,1.0,10,3.9
2025-08-26T11:40:19.506043,0,1852,1.0,10,4.2
2025-08-26T11:40:20.006830,0,1852,1.0,10,4.3
2025-08-26T11:40:20.507769,0,1852,1.0,10,3.8
2025-08-26T11:40:21.008409,0,1852,1.0,10,4.1
2025-08-26T11:40:21.509053,0,1852,1.0,10,3.8
2025-08-26T11:40:22.009676,0,1852,1.0,10,3.9
2025-08-26T11:40:22.510438,0,1852,1.0,10,5.9
2025-08-26T11:40:23.011076,0,1852,1.0,10,4.1
2025-08-26T11:40:23.511541,0,1852,1.0,10,3.4
2025-08-26T11:40:24.011907,0,1852,1.0,10,3.4
2025-08-26T11:40:24.512184,0,1852,1.0,10,3.4
2025-08-26T11:40:25.012502,0,1852,1.0,10,4.1
2025-08-26T11:40:25.512833,0,1852,1.0,10,4.0
2025-08-26T11:40:26.013215,0,1852,1.0,10,3.7
2025-08-26T11:40:26.513543,0,1852,1.0,10,3.5
2025-08-26T11:40:27.013840,0,1852,1.0,10,3.6
2025-08-26T11:40:27.514268,0,1852,1.0,10,3.6
2025-08-26T11:40:28.014555,0,1852,1.0,10,4.0
2025-08-26T11:40:28.514949,0,1852,1.0,10,3.6
2025-08-26T11:40:29.015529,0,1852,1.0,10,3.5
2025-08-26T11:40:29.516142,0,1852,1.0,10,4.0
2025-08-26T11:40:30.016723,0,1852,1.0,10,3.8
2025-08-26T11:40:30.517346,0,1852,1.0,10,3.4
2025-08-26T11:40:31.017946,0,1852,1.0,10,3.7
2025-08-26T11:40:31.518544,0,1852,1.0,10,3.9
2025-08-26T11:40:32.018905,0,1852,1.0,10,5.0
2025-08-26T11:40:32.519491,0,1852,1.0,10,5.0
2025-08-26T11:40:33.020074,0,1852,1.0,10,3.6
2025-08-26T11:40:33.520690,0,1852,1.0,10,4.1
2025-08-26T11:40:34.021293,0,1852,1.0,10,3.8
2025-08-26T11:40:34.521923,0,1852,1.0,10,3.6
2025-08-26T11:40:35.022269,0,1852,1.0,10,3.9
2025-08-26T11:40:35.522564,0,1852,1.0,10,4.8
2025-08-26T11:40:36.022803,0,1852,1.0,10,3.1
2025-08-26T11:40:36.523068,0,1852,1.0,10,4.4
2025-08-26T11:40:37.023321,0,1852,1.0,10,3.6
2025-08-26T11:40:37.523581,0,1852,1.0,10,3.8
2025-08-26T11:40:38.023819,0,1852,1.0,10,3.4
2025-08-26T11:40:38.524345,0,1852,1.0,10,3.3
2025-08-26T11:40:39.024591,0,1852,1.0,10,3.2
2025-08-26T11:40:39.524843,0,1852,1.0,10,4.0
2025-08-26T11:40:40.025384,0,1852,1.0,10,3.8
2025-08-26T11:40:40.526000,0,1852,1.0,10,3.9
2025-08-26T11:40:41.026538,0,1852,1.0,10,3.7
2025-08-26T11:40:41.527168,0,1852,1.0,10,3.6
2025-08-26T11:40:42.027739,0,1852,1.0,10,3.5
2025-08-26T11:40:42.528360,0,1852,1.0,10,3.4
2025-08-26T11:40:43.028922,0,1852,1.0,10,3.3
2025-08-26T11:40:43.529507,0,1852,1.0,10,3.8
2025-08-26T11:40:44.029945,0,1852,1.0,10,3.5
2025-08-26T11:40:44.530227,0,1852,1.0,10,3.3
2025-08-26T11:40:45.030465,0,1852,1.0,10,3.6
2025-08-26T11:40:45.530707,0,1852,1.0,10,7.4
2025-08-26T11:40:46.030953,0,1852,1.0,10,4.3
2025-08-26T11:40:46.531237,0,1852,1.0,10,4.1
2025-08-26T11:40:47.031494,0,1852,1.0,10,4.5
2025-08-26T11:40:47.531753,0,1852,1.0,10,3.6
2025-08-26T11:40:48.032003,0,1852,1.0,10,4.0
2025-08-26T11:40:48.532268,0,1852,1.0,10,3.7
2025-08-26T11:40:49.032531,0,1852,1.0,10,3.7
2025-08-26T11:40:49.532885,0,1852,1.0,10,3.5
2025-08-26T11:40:50.033149,0,1852,1.0,10,3.4
2025-08-26T11:40:50.533454,0,1852,1.0,10,3.4
2025-08-26T11:40:51.033981,0,1852,1.0,10,3.4
2025-08-26T11:40:51.534568,0,1852,1.0,10,3.5
2025-08-26T11:40:52.035249,0,1852,1.0,10,3.4
2025-08-26T11:40:52.536031,0,1852,1.0,10,3.6
2025-08-26T11:40:53.036659,0,1852,1.0,10,3.7
2025-08-26T11:40:53.537328,0,1852,1.0,10,3.6
2025-08-26T11:40:54.037912,0,1852,1.0,10,4.8
2025-08-26T11:40:54.538552,0,1852,1.0,10,4.3
2025-08-26T11:40:55.039171,0,1852,1.0,10,3.6
2025-08-26T11:40:55.539755,0,1852,1.0,10,3.3
2025-08-26T11:40:56.040460,0,1852,1.0,10,3.2
2025-08-26T11:40:56.541059,0,1852,1.0,10,3.2
2025-08-26T11:40:57.041623,0,1852,1.0,10,3.5
2025-08-26T11:40:57.542110,0,1852,1.0,10,3.3
2025-08-26T11:40:58.042393,0,1852,1.0,10,3.5
2025-08-26T11:40:58.542640,0,1852,1.0,10,3.4
2025-08-26T11:40:59.042861,0,1852,1.0,10,5.1
2025-08-26T11:40:59.543114,0,1852,1.0,10,4.9
2025-08-26T11:41:00.043336,0,1852,1.0,10,5.0
2025-08-26T11:41:00.543578,0,1852,1.0,10,4.3
2025-08-26T11:41:01.043812,0,1852,1.0,10,5.0
2025-08-26T11:41:01.544065,0,1852,1.0,10,4.0
2025-08-26T11:41:02.044298,0,1852,1.0,10,4.7
2025-08-26T11:41:02.544548,0,1852,1.0,10,3.4
2025-08-26T11:41:03.044819,0,1852,1.0,10,3.3
2025-08-26T11:41:03.545166,0,1852,1.0,10,3.8
2025-08-26T11:41:04.045532,0,1852,1.0,10,4.7
2025-08-26T11:41:04.545807,0,1852,1.0,10,5.2
2025-08-26T11:41:05.046326,0,1852,1.0,10,5.7
2025-08-26T11:41:05.546655,0,1852,1.0,10,6.2
2025-08-26T11:41:06.047186,0,1852,1.0,10,5.0
2025-08-26T11:41:06.547498,0,1852,1.0,10,8.2
2025-08-26T11:41:07.047734,0,1852,1.0,10,9.9
2025-08-26T11:41:07.547978,0,1852,1.0,10,9.9
2025-08-26T11:41:08.048209,0,1852,1.0,10,8.3
2025-08-26T11:41:08.548460,0,1852,1.0,10,6.1
2025-08-26T11:41:09.048685,0,1852,1.0,10,4.7
2025-08-26T11:41:09.548933,0,1852,1.0,10,5.9
2025-08-26T11:41:10.049179,0,1852,1.0,10,3.4
2025-08-26T11:41:10.549403,0,1852,1.0,10,4.0
2025-08-26T11:41:11.049622,0,1852,1.0,10,4.1
2025-08-26T11:41:11.549844,0,1852,1.0,10,4.0
2025-08-26T11:41:12.050063,0,1852,1.0,10,4.5
2025-08-26T11:41:12.550361,0,1852,1.0,10,4.7
2025-08-26T11:41:13.050980,0,1852,1.0,10,3.7
2025-08-26T11:41:13.551660,0,1852,1.0,10,3.6
2025-08-26T11:41:14.052301,0,1852,1.0,10,3.3
2025-08-26T11:41:14.552859,0,1852,1.0,10,5.0
2025-08-26T11:41:15.053417,0,1852,1.0,10,3.8
2025-08-26T11:41:15.554048,0,1852,1.0,10,3.6
2025-08-26T11:41:16.054388,0,1852,1.0,10,6.9
2025-08-26T11:41:16.554688,0,1852,1.0,10,5.3
2025-08-26T11:41:17.055247,0,1852,1.0,10,4.8
2025-08-26T11:41:17.555541,0,1852,1.0,10,3.8
2025-08-26T11:41:18.056056,0,1852,1.0,10,3.2
2025-08-26T11:41:18.556668,0,1852,1.0,10,3.4
2025-08-26T11:41:19.057269,0,1852,1.0,10,3.4
2025-08-26T11:41:19.557903,0,1852,1.0,10,3.5
2025-08-26T11:41:20.058535,0,1852,1.0,10,3.3
2025-08-26T11:41:20.559174,0,1852,1.0,10,4.3
2025-08-26T11:41:21.059790,0,1852,1.0,10,3.6
2025-08-26T11:41:21.560214,0,1852,1.0,10,5.2
2025-08-26T11:41:22.060508,0,1852,1.0,10,3.3
2025-08-26T11:41:22.560813,0,1852,1.0,10,3.7
2025-08-26T11:41:23.061052,0,1852,1.0,10,3.0
2025-08-26T11:41:23.561258,0,1852,1.0,10,3.6
2025-08-26T11:41:24.061494,0,1852,1.0,10,3.3
2025-08-26T11:41:24.561738,0,1852,1.0,10,3.4
2025-08-26T11:41:25.061965,0,1852,1.0,10,3.4
2025-08-26T11:41:25.562270,0,1852,1.0,10,2.8
2025-08-26T11:41:26.062553,0,1852,1.0,10,2.9
2025-08-26T11:41:26.562799,0,1852,1.0,10,3.3
2025-08-26T11:41:27.063036,0,1852,1.0,10,3.0
2025-08-26T11:41:27.563338,0,1852,1.0,10,3.5
2025-08-26T11:41:28.063880,0,1852,1.0,10,3.5
2025-08-26T11:41:28.564524,0,1852,1.0,10,3.9
2025-08-26T11:41:29.065128,0,1852,1.0,10,3.5
2025-08-26T11:41:29.565694,0,1852,1.0,10,3.8
2025-08-26T11:41:30.066294,0,1852,1.0,10,3.6
2025-08-26T11:41:30.566974,0,1852,1.0,10,3.8
2025-08-26T11:41:31.067647,0,1852,1.0,10,3.4
2025-08-26T11:41:31.567997,0,1852,1.0,10,3.5
2025-08-26T11:41:32.068259,0,1852,1.0,10,3.1
2025-08-26T11:41:32.568509,0,1852,1.0,10,3.2
2025-08-26T11:41:33.068761,0,1852,1.0,10,3.4
2025-08-26T11:41:33.568988,0,1852,1.0,10,3.9
2025-08-26T11:41:34.069279,0,1852,1.0,10,3.4
2025-08-26T11:41:34.569549,0,1852,1.0,10,3.6
2025-08-26T11:41:35.069829,0,1852,1.0,10,4.0
2025-08-26T11:41:35.570087,0,1852,1.0,10,4.0
2025-08-26T11:41:36.070335,0,1852,1.0,10,3.4
2025-08-26T11:41:36.570668,0,1852,1.0,10,3.6
2025-08-26T11:41:37.071596,0,1852,1.0,10,3.5
2025-08-26T11:41:37.572557,0,1852,1.0,10,3.3
2025-08-26T11:41:38.073501,0,1852,1.0,10,3.3
2025-08-26T11:41:38.574090,0,1852,1.0,10,3.6
2025-08-26T11:41:39.074789,0,1852,1.0,10,3.7
2025-08-26T11:41:39.575466,0,1852,1.0,10,3.6
2025-08-26T11:41:40.076071,0,1852,1.0,10,3.9
2025-08-26T11:41:40.576648,0,1852,1.0,10,4.0
2025-08-26T11:41:41.077271,0,1852,1.0,10,3.5
2025-08-26T11:41:41.577734,0,1852,1.0,10,3.3
2025-08-26T11:41:42.078002,0,1852,1.0,10,3.6
2025-08-26T11:41:42.578251,0,1852,1.0,10,3.4
2025-08-26T11:41:43.078574,0,1852,1.0,10,3.5
2025-08-26T11:41:43.578858,0,1852,1.0,10,3.1
2025-08-26T11:41:44.079148,0,1852,1.0,10,3.2
2025-08-26T11:41:44.579407,0,1852,1.0,10,3.0
2025-08-26T11:41:45.079659,0,1852,1.0,10,3.1
2025-08-26T11:41:45.579911,0,1852,1.0,10,3.1
2025-08-26T11:41:46.080151,0,1852,1.0,10,3.6
2025-08-26T11:41:46.580522,0,1852,1.0,10,3.7
2025-08-26T11:41:47.081067,0,1852,1.0,10,3.8
2025-08-26T11:41:47.581660,0,1852,1.0,10,3.5
2025-08-26T11:41:48.082251,0,1852,1.0,10,3.7
2025-08-26T11:41:48.582831,0,1852,1.0,10,3.7
2025-08-26T11:41:49.083475,0,1852,1.0,10,3.5
2025-08-26T11:41:49.584053,0,1852,1.0,10,3.3
2025-08-26T11:41:50.084666,0,1852,1.0,10,3.1
2025-08-26T11:41:50.585313,0,1852,1.0,10,3.3
2025-08-26T11:41:51.085724,0,1852,1.0,10,3.6
2025-08-26T11:41:51.586113,0,1852,1.0,10,3.4
2025-08-26T11:41:52.086361,0,1852,1.0,10,3.1
2025-08-26T11:41:52.586628,0,1852,1.0,10,3.3
2025-08-26T11:41:53.086876,0,1852,1.0,10,3.3
2025-08-26T11:41:53.587141,0,1852,1.0,10,3.4
2025-08-26T11:41:54.087376,0,1852,1.0,10,3.3
2025-08-26T11:41:54.587617,0,1852,1.0,10,3.2
2025-08-26T11:41:55.087874,0,1852,1.0,10,3.1
2025-08-26T11:41:55.588127,0,1852,1.0,10,2.9
2025-08-26T11:41:56.088372,0,1852,1.0,10,3.4
2025-08-26T11:41:56.588625,0,1852,1.0,10,3.2
2025-08-26T11:41:57.088867,0,1852,1.0,10,3.0
2025-08-26T11:41:57.589380,0,1852,1.0,10,3.6
2025-08-26T11:41:58.089970,0,1852,1.0,10,3.4
2025-08-26T11:41:58.590546,0,1852,1.0,10,3.7
2025-08-26T11:41:59.091126,0,1852,1.0,10,3.8
2025-08-26T11:41:59.591697,0,1852,1.0,10,4.5
2025-08-26T11:42:00.092291,0,1852,1.0,10,4.5
2025-08-26T11:42:00.592857,0,1852,1.0,10,3.8
2025-08-26T11:42:01.093196,0,1852,1.0,10,7.3
2025-08-26T11:42:01.593605,0,1852,1.0,10,4.5
2025-08-26T11:42:02.093885,0,1852,1.0,10,4.3
2025-08-26T11:42:02.594121,0,1852,1.0,10,4.5
2025-08-26T11:42:03.094352,0,1852,1.0,10,3.6
2025-08-26T11:42:03.594582,0,1852,1.0,10,3.6
2025-08-26T11:42:04.094835,0,1852,1.0,10,3.2
2025-08-26T11:42:04.595142,0,1852,1.0,10,3.3
2025-08-26T11:42:05.095385,0,1852,1.0,10,3.3
2025-08-26T11:42:05.595633,0,1852,1.0,10,3.3
2025-08-26T11:42:06.095878,0,1852,1.0,10,3.5
2025-08-26T11:42:06.596122,0,1852,1.0,10,3.4
2025-08-26T11:42:07.096408,0,1852,1.0,10,7.3
2025-08-26T11:42:07.596791,0,1852,1.0,10,5.3
2025-08-26T11:42:08.097434,0,1852,1.0,10,5.3
2025-08-26T11:42:08.597822,0,1852,1.0,10,5.6
2025-08-26T11:42:09.098380,0,1852,1.0,10,3.6
2025-08-26T11:42:09.599337,0,1852,1.0,10,3.5
2025-08-26T11:42:10.099677,0,1852,1.0,10,5.7
2025-08-26T11:42:10.600111,0,1852,1.0,10,4.7
2025-08-26T11:42:11.100363,0,1852,1.0,10,5.6
2025-08-26T11:42:11.600593,0,1852,1.0,10,4.4
2025-08-26T11:42:12.100855,0,1852,1.0,10,3.8
2025-08-26T11:42:12.601117,0,1852,1.0,10,3.6
2025-08-26T11:42:13.101445,0,1852,1.0,10,3.3
2025-08-26T11:42:13.601730,0,1852,1.0,10,5.3
2025-08-26T11:42:14.101996,0,1852,1.0,10,3.1
2025-08-26T11:42:14.602229,0,1852,1.0,10,3.4
2025-08-26T11:42:15.102479,0,1852,1.0,10,3.3
2025-08-26T11:42:15.602711,0,1852,1.0,10,3.2
2025-08-26T11:42:16.102946,0,1852,1.0,10,3.2
2025-08-26T11:42:16.603332,0,1852,1.0,10,3.3
2025-08-26T11:42:17.103906,0,1852,1.0,10,3.4
2025-08-26T11:42:17.604383,0,1852,1.0,10,4.0
2025-08-26T11:42:18.104979,0,1852,1.0,10,3.7
2025-08-26T11:42:18.605563,0,1852,1.0,10,3.7
2025-08-26T11:42:19.106241,0,1852,1.0,10,3.7
2025-08-26T11:42:19.606837,0,1852,1.0,10,3.7
2025-08-26T11:42:20.107495,0,1852,1.0,10,3.3
2025-08-26T11:42:20.607882,0,1852,1.0,10,3.4
2025-08-26T11:42:21.108140,0,1852,1.0,10,3.4
2025-08-26T11:42:21.608368,0,1852,1.0,10,3.3
2025-08-26T11:42:22.108611,0,1852,1.0,10,3.3
2025-08-26T11:42:22.608842,0,1852,1.0,10,3.4
2025-08-26T11:42:23.109078,0,1852,1.0,10,3.4
2025-08-26T11:42:23.609304,0,1852,1.0,10,3.6
2025-08-26T11:42:24.109602,0,1852,1.0,10,3.2
2025-08-26T11:42:24.609877,0,1852,1.0,10,3.3
2025-08-26T11:42:25.110166,0,1852,1.0,10,3.4
2025-08-26T11:42:25.610450,0,1852,1.0,10,4.0
2025-08-26T11:42:26.110711,0,1852,1.0,10,4.3
2025-08-26T11:42:26.610943,0,1852,1.0,10,3.6
2025-08-26T11:42:27.111354,0,1852,1.0,10,3.8
2025-08-26T11:42:27.611883,0,1852,1.0,10,3.6
2025-08-26T11:42:28.112474,0,1852,1.0,10,3.7
2025-08-26T11:42:28.613009,0,1852,1.0,10,3.7
2025-08-26T11:42:29.113625,0,1852,1.0,10,3.4
2025-08-26T11:42:29.614207,0,1852,1.0,10,3.3
2025-08-26T11:42:30.114881,0,1852,1.0,10,3.3
2025-08-26T11:42:30.615504,0,1852,1.0,10,3.8
2025-08-26T11:42:31.115810,0,1852,1.0,10,3.5
2025-08-26T11:42:31.616048,0,1852,1.0,10,3.5
2025-08-26T11:42:32.116531,0,1852,1.0,10,3.8
2025-08-26T11:42:32.617127,0,1852,1.0,10,3.9
2025-08-26T11:42:33.117549,0,1852,1.0,10,3.5
2025-08-26T11:42:33.617816,0,1852,1.0,10,4.4
2025-08-26T11:42:34.118075,0,1852,1.0,10,5.8
2025-08-26T11:42:34.618300,0,1852,1.0,10,4.1
2025-08-26T11:42:35.118595,0,1852,1.0,10,3.6
2025-08-26T11:42:35.619183,0,1852,1.0,10,4.0
2025-08-26T11:42:36.119900,0,1852,1.0,10,3.8
2025-08-26T11:42:36.620212,0,1852,1.0,10,3.8
2025-08-26T11:42:37.120477,0,1852,1.0,10,3.8
2025-08-26T11:42:37.620725,0,1852,1.0,10,3.9
2025-08-26T11:42:38.121011,0,1852,1.0,10,3.8
2025-08-26T11:42:38.621566,0,1852,1.0,10,3.4
2025-08-26T11:42:39.122215,0,1852,1.0,10,3.7
2025-08-26T11:42:39.622839,0,1852,1.0,10,3.1
2025-08-26T11:42:40.123147,0,1852,1.0,10,4.1
2025-08-26T11:42:40.623411,0,1852,1.0,10,3.8
2025-08-26T11:42:41.123842,0,1852,1.0,10,3.4
2025-08-26T11:42:41.624094,0,1852,1.0,10,4.1
2025-08-26T11:42:42.124663,0,1852,1.0,10,3.5
2025-08-26T11:42:42.624981,0,1852,1.0,10,4.2
2025-08-26T11:42:43.125205,0,1852,1.0,10,3.9
2025-08-26T11:42:43.625786,0,1852,1.0,10,3.8
2025-08-26T11:42:44.126134,0,1852,1.0,10,4.1
2025-08-26T11:42:44.626403,0,1852,1.0,10,4.3
2025-08-26T11:42:45.126654,0,1852,1.0,10,3.9
2025-08-26T11:42:45.627516,0,1852,1.0,10,3.8
2025-08-26T11:42:46.127927,0,1852,1.0,10,3.8
2025-08-26T11:42:46.628547,0,1852,1.0,10,3.9
2025-08-26T11:42:47.128973,0,1852,1.0,10,4.3
2025-08-26T11:42:47.629543,0,1852,1.0,10,4.0
2025-08-26T11:42:48.130160,0,1852,1.0,10,3.8
2025-08-26T11:42:48.630478,0,1852,1.0,10,3.9
2025-08-26T11:42:49.130707,0,1852,1.0,10,3.9
2025-08-26T11:42:49.631254,0,1852,1.0,10,3.7
2025-08-26T11:42:50.131545,0,1852,1.0,10,3.9
2025-08-26T11:42:50.631776,0,1852,1.0,10,3.9
2025-08-26T11:42:51.132298,0,1852,1.0,10,3.6
2025-08-26T11:42:51.632579,0,1852,1.0,10,3.9
2025-08-26T11:42:52.133188,0,1852,1.0,10,3.6
2025-08-26T11:42:52.633479,0,1852,1.0,10,4.2
2025-08-26T11:42:53.133730,0,1852,1.0,10,4.0
2025-08-26T11:42:53.633966,0,1852,1.0,10,3.9
2025-08-26T11:42:54.134524,0,1852,1.0,10,3.5
2025-08-26T11:42:54.634818,0,1852,1.0,10,3.8
2025-08-26T11:42:55.135092,0,1852,1.0,10,3.9
2025-08-26T11:42:55.635581,0,1852,1.0,10,3.6
2025-08-26T11:42:56.135886,0,1852,1.0,10,4.0
2025-08-26T11:42:56.636149,0,1852,1.0,10,4.2
2025-08-26T11:42:57.136643,0,1852,1.0,10,3.5
2025-08-26T11:42:57.636931,0,1852,1.0,10,3.9
2025-08-26T11:42:58.137263,0,1852,1.0,10,3.9
2025-08-26T11:42:58.637809,0,1852,1.0,10,3.9
2025-08-26T11:42:59.138165,0,1852,1.0,10,3.9
2025-08-26T11:42:59.638398,0,1852,1.0,10,4.1
2025-08-26T11:43:00.138911,0,1852,1.0,10,3.3
2025-08-26T11:43:00.639223,0,1852,1.0,10,3.9
2025-08-26T11:43:01.139497,0,1852,1.0,10,3.9
2025-08-26T11:43:01.640032,0,1852,1.0,10,3.6
2025-08-26T11:43:02.140401,0,1852,1.0,10,3.8
2025-08-26T11:43:02.640651,0,1852,1.0,10,4.1
2025-08-26T11:43:03.141059,0,1852,1.0,10,3.7
2025-08-26T11:43:03.641406,0,1852,1.0,10,4.0
2025-08-26T11:43:04.141664,0,1852,1.0,10,3.8
2025-08-26T11:43:04.642181,0,1852,1.0,10,3.7
2025-08-26T11:43:05.142485,0,1852,1.0,10,3.6
2025-08-26T11:43:05.642773,0,1852,1.0,10,3.8
2025-08-26T11:43:06.143063,0,1852,1.0,10,3.9
2025-08-26T11:43:06.643602,0,1852,1.0,10,3.9
2025-08-26T11:43:07.143913,0,1852,1.0,10,3.9
2025-08-26T11:43:07.644274,0,1852,1.0,10,3.8
2025-08-26T11:43:08.144507,0,1852,1.0,10,3.6
2025-08-26T11:43:08.644759,0,1852,1.0,10,4.3
2025-08-26T11:43:09.145158,0,1852,1.0,10,3.9
2025-08-26T11:43:09.645441,0,1852,1.0,10,4.2
2025-08-26T11:43:10.145700,0,1852,1.0,10,4.1
2025-08-26T11:43:10.645970,0,1852,1.0,10,3.8
2025-08-26T11:43:11.146280,0,1852,1.0,10,4.0
2025-08-26T11:43:11.646561,0,1852,1.0,10,4.0
2025-08-26T11:43:12.146829,0,1852,1.0,10,3.9
2025-08-26T11:43:12.647359,0,1852,1.0,10,3.7
2025-08-26T11:43:13.147664,0,1852,1.0,10,4.0
2025-08-26T11:43:13.647906,0,1852,1.0,10,3.8
2025-08-26T11:43:14.148487,0,1852,1.0,10,3.5
2025-08-26T11:43:14.648806,0,1852,1.0,10,4.1
2025-08-26T11:43:15.149070,0,1852,1.0,10,3.8
2025-08-26T11:43:15.649577,0,1852,1.0,10,4.0
2025-08-26T11:43:16.149896,0,1852,1.0,10,4.0
2025-08-26T11:43:16.650154,0,1852,1.0,10,3.8
2025-08-26T11:43:17.150670,0,1852,1.0,10,3.5
2025-08-26T11:43:17.650985,0,1852,1.0,10,6.3
2025-08-26T11:43:18.151255,0,1852,1.0,10,3.7
2025-08-26T11:43:18.651794,0,1852,1.0,10,4.0
2025-08-26T11:43:19.152109,0,1852,1.0,10,3.8
2025-08-26T11:43:19.652349,0,1852,1.0,10,3.7
2025-08-26T11:43:20.152592,0,1852,1.0,10,3.4
2025-08-26T11:43:20.652845,0,1852,1.0,10,3.9
2025-08-26T11:43:21.153093,0,1852,1.0,10,3.9
2025-08-26T11:43:21.653355,0,1852,1.0,10,3.9
2025-08-26T11:43:22.153611,0,1852,1.0,10,3.8
2025-08-26T11:43:22.654185,0,1852,1.0,10,3.9
2025-08-26T11:43:23.154504,0,1852,1.0,10,3.8
2025-08-26T11:43:23.654768,0,1852,1.0,10,4.0
2025-08-26T11:43:24.155072,0,1852,1.0,10,3.9
2025-08-26T11:43:24.655414,0,1852,1.0,10,3.8
2025-08-26T11:43:25.155684,0,1852,1.0,10,3.8
2025-08-26T11:43:25.656254,0,1852,1.0,10,3.8
2025-08-26T11:43:26.156562,0,1852,1.0,10,3.7
2025-08-26T11:43:26.656811,0,1852,1.0,10,4.1
2025-08-26T11:43:27.157124,0,1852,1.0,10,3.9
2025-08-26T11:43:27.657659,0,1852,1.0,10,3.8
2025-08-26T11:43:28.157967,0,1852,1.0,10,3.9
2025-08-26T11:43:28.658288,0,1852,1.0,10,3.9
2025-08-26T11:43:29.158794,0,1852,1.0,10,3.6
2025-08-26T11:43:29.659137,0,1852,1.0,10,3.8
2025-08-26T11:43:30.159689,0,1852,1.0,10,3.8
2025-08-26T11:43:30.660327,0,1852,1.0,10,4.3
2025-08-26T11:43:31.160652,0,1852,1.0,10,3.9
2025-08-26T11:43:31.660956,0,1852,1.0,10,3.8
2025-08-26T11:43:32.161291,0,1852,1.0,10,3.6
2025-08-26T11:43:32.661541,0,1852,1.0,10,3.9
2025-08-26T11:43:33.161792,0,1852,1.0,10,4.1
2025-08-26T11:43:33.662058,0,1852,1.0,10,4.3
2025-08-26T11:43:34.162309,0,1852,1.0,10,3.9
2025-08-26T11:43:34.662583,0,1852,1.0,10,4.0
2025-08-26T11:43:35.163011,0,1852,1.0,10,3.9
2025-08-26T11:43:35.663254,0,1852,1.0,10,4.3
2025-08-26T11:43:36.163549,0,1852,1.0,10,4.1
2025-08-26T11:43:36.663844,0,1852,1.0,10,4.5
2025-08-26T11:43:37.164113,0,1852,1.0,10,3.8
2025-08-26T11:43:37.664523,0,1852,1.0,10,3.9
2025-08-26T11:43:38.165022,0,1852,1.0,10,3.4
2025-08-26T11:43:38.665347,0,1852,1.0,10,4.2
2025-08-26T11:43:39.165606,0,1852,1.0,10,3.9
2025-08-26T11:43:39.666142,0,1852,1.0,10,3.7
2025-08-26T11:43:40.166485,0,1852,1.0,10,4.1
2025-08-26T11:43:40.666745,0,1852,1.0,10,4.3
2025-08-26T11:43:41.167346,0,1852,1.0,10,3.8
2025-08-26T11:43:41.667643,0,1852,1.0,10,4.3
2025-08-26T11:43:42.167895,0,1852,1.0,10,3.8
2025-08-26T11:43:42.668141,0,1852,1.0,10,5.1
2025-08-26T11:43:43.168394,0,1852,1.0,10,3.8
2025-08-26T11:43:43.668663,0,1852,1.0,10,4.0
2025-08-26T11:43:44.168975,0,1852,1.0,10,3.4
2025-08-26T11:43:44.669237,0,1852,1.0,10,3.9
2025-08-26T11:43:45.169502,0,1852,1.0,10,3.9
2025-08-26T11:43:45.669908,0,1852,1.0,10,4.0
2025-08-26T11:43:46.170501,0,1852,1.0,10,4.6
2025-08-26T11:43:46.670813,0,1852,1.0,10,4.3
2025-08-26T11:43:47.171087,0,1852,1.0,10,4.4
2025-08-26T11:43:47.671355,0,1852,1.0,10,5.6
2025-08-26T11:43:48.171624,0,1852,1.0,10,4.8
2025-08-26T11:43:48.672161,0,1852,1.0,10,4.0
2025-08-26T11:43:49.172475,0,1852,1.0,10,3.8
2025-08-26T11:43:49.672728,0,1852,1.0,10,4.6
2025-08-26T11:43:50.173012,0,1852,1.0,10,4.3
2025-08-26T11:43:50.673350,0,1852,1.0,10,6.6
2025-08-26T11:43:51.173615,0,1852,1.0,10,5.9
2025-08-26T11:43:51.673879,0,1852,1.0,10,4.7
2025-08-26T11:43:52.174421,0,1852,1.0,10,3.7
2025-08-26T11:43:52.674716,0,1852,1.0,10,4.7
2025-08-26T11:43:53.175031,0,1852,1.0,10,4.0
2025-08-26T11:43:53.675349,0,1852,1.0,10,4.2
2025-08-26T11:43:54.175603,0,1852,1.0,10,3.8
2025-08-26T11:43:54.675848,0,1852,1.0,10,4.2
2025-08-26T11:43:55.176196,0,1852,1.0,10,4.5
2025-08-26T11:43:55.676589,0,1852,1.0,10,3.8
2025-08-26T11:43:56.176847,0,1852,1.0,10,4.1
2025-08-26T11:43:56.677104,0,1852,1.0,10,4.2
2025-08-26T11:43:57.177598,0,1852,1.0,10,3.5
2025-08-26T11:43:57.677911,0,1852,1.0,10,4.5
2025-08-26T11:43:58.178151,0,1852,1.0,10,3.8
2025-08-26T11:43:58.678709,0,1852,1.0,10,4.1
2025-08-26T11:43:59.179010,0,1852,1.0,10,3.9
2025-08-26T11:43:59.679254,0,1852,1.0,10,3.9
2025-08-26T11:44:00.179744,0,1852,1.0,10,4.0
2025-08-26T11:44:00.680075,0,1852,1.0,10,4.3
2025-08-26T11:44:01.180366,0,1852,1.0,10,4.1
2025-08-26T11:44:01.680919,0,1852,1.0,10,4.3
2025-08-26T11:44:02.181247,0,1852,1.0,10,4.0
2025-08-26T11:44:02.681580,0,1852,1.0,10,4.4
2025-08-26T11:44:03.181858,0,1852,1.0,10,4.5
2025-08-26T11:44:03.682473,0,1852,1.0,10,4.6
2025-08-26T11:44:04.182795,0,1852,1.0,10,3.9
2025-08-26T11:44:04.683065,0,1852,1.0,10,3.8
2025-08-26T11:44:05.183354,0,1852,1.0,10,3.8
2025-08-26T11:44:05.683606,0,1852,1.0,10,3.9
2025-08-26T11:44:06.183874,0,1852,1.0,10,4.2
2025-08-26T11:44:06.684170,0,1852,1.0,10,3.8
2025-08-26T11:44:07.184411,0,1852,1.0,10,3.9
2025-08-26T11:44:07.684643,0,1852,1.0,10,3.8
2025-08-26T11:44:08.184867,0,1852,1.0,10,3.6
2025-08-26T11:44:08.685116,0,1852,1.0,10,4.6
2025-08-26T11:44:09.185363,0,1852,1.0,10,4.1
2025-08-26T11:44:09.685886,0,1852,1.0,10,4.3
2025-08-26T11:44:10.186189,0,1852,1.0,10,4.1
2025-08-26T11:44:10.686497,0,1852,1.0,10,4.4
2025-08-26T11:44:11.187014,0,1852,1.0,10,3.9
2025-08-26T11:44:11.687342,0,1852,1.0,10,4.1
2025-08-26T11:44:12.187566,0,1852,1.0,10,3.9
2025-08-26T11:44:12.687813,0,1852,1.0,10,4.1
2025-08-26T11:44:13.188046,0,1852,1.0,10,4.1
2025-08-26T11:44:13.688258,0,1852,1.0,10,4.2
2025-08-26T11:44:14.188778,0,1852,1.0,10,3.8
2025-08-26T11:44:14.689087,0,1852,1.0,10,4.1
2025-08-26T11:44:15.189377,0,1852,1.0,10,3.8
2025-08-26T11:44:15.689932,0,1852,1.0,10,4.1
2025-08-26T11:44:16.190268,0,1852,1.0,10,3.8
2025-08-26T11:44:16.690561,0,1852,1.0,10,3.8
2025-08-26T11:44:17.190806,0,1852,1.0,10,4.0
2025-08-26T11:44:17.691061,0,1852,1.0,10,3.9
2025-08-26T11:44:18.191317,0,1852,1.0,10,4.0
2025-08-26T11:44:18.691843,0,1852,1.0,10,4.0
2025-08-26T11:44:19.192132,0,1852,1.0,10,4.2
2025-08-26T11:44:19.692384,0,1852,1.0,10,4.5
2025-08-26T11:44:20.192925,0,1852,1.0,10,3.5
2025-08-26T11:44:20.693312,0,1852,1.0,10,4.1
2025-08-26T11:44:21.193560,0,1852,1.0,10,3.8
2025-08-26T11:44:21.694128,0,1852,1.0,10,3.6
2025-08-26T11:44:22.194423,0,1852,1.0,10,3.9
2025-08-26T11:44:22.694626,0,1852,1.0,10,3.9
2025-08-26T11:44:23.194872,0,1852,1.0,10,4.0
2025-08-26T11:44:23.695412,0,1852,1.0,10,4.3
2025-08-26T11:44:24.195696,0,1852,1.0,10,4.3
2025-08-26T11:44:24.695963,0,1852,1.0,10,3.9
2025-08-26T11:44:25.196401,0,1852,1.0,10,3.6
2025-08-26T11:44:25.696685,0,1852,1.0,10,3.9
2025-08-26T11:44:26.196926,0,1852,1.0,10,3.9
2025-08-26T11:44:26.697490,0,1852,1.0,10,3.9
2025-08-26T11:44:27.197786,0,1852,1.0,10,4.6
2025-08-26T11:44:27.698045,0,1852,1.0,10,4.1
2025-08-26T11:44:28.198514,0,1852,1.0,10,3.2
2025-08-26T11:44:28.698815,0,1852,1.0,10,4.1
2025-08-26T11:44:29.199063,0,1852,1.0,10,3.9
2025-08-26T11:44:29.699341,0,1852,1.0,10,3.6
2025-08-26T11:44:30.199712,0,1852,1.0,10,4.1
2025-08-26T11:44:30.699991,0,1852,1.0,10,3.9
2025-08-26T11:44:31.200613,0,1852,1.0,10,3.7
2025-08-26T11:44:31.700956,0,1852,1.0,10,4.2
2025-08-26T11:44:32.201253,0,1852,1.0,10,3.9
2025-08-26T11:44:32.701810,0,1852,1.0,10,3.9
2025-08-26T11:44:33.202120,0,1852,1.0,10,4.1
2025-08-26T11:44:33.702450,0,1852,1.0,10,4.5
2025-08-26T11:44:34.202694,0,1852,1.0,10,4.2
2025-08-26T11:44:34.703238,0,1852,1.0,10,3.9
2025-08-26T11:44:35.203561,0,1852,1.0,10,4.3
2025-08-26T11:44:35.703796,0,1852,1.0,10,3.8
2025-08-26T11:44:36.204292,0,1852,1.0,10,3.9
2025-08-26T11:44:36.704589,0,1852,1.0,10,4.7
2025-08-26T11:44:37.204826,0,1852,1.0,10,3.8
2025-08-26T11:44:37.705570,0,1852,1.0,10,4.4
2025-08-26T11:44:38.205862,0,1852,1.0,10,4.2
2025-08-26T11:44:38.706120,0,1852,1.0,10,4.1
2025-08-26T11:44:39.206606,0,1852,1.0,10,3.5
2025-08-26T11:44:39.706902,0,1852,1.0,10,4.3
2025-08-26T11:44:40.207156,0,1852,1.0,10,3.9
2025-08-26T11:44:40.707670,0,1852,1.0,10,4.0
2025-08-26T11:44:41.207970,0,1852,1.0,10,4.1
2025-08-26T11:44:41.708294,0,1852,1.0,10,4.6
2025-08-26T11:44:42.208796,0,1852,1.0,10,3.6
2025-08-26T11:44:42.709063,0,1852,1.0,10,4.1
2025-08-26T11:44:43.209308,0,1852,1.0,10,3.9
2025-08-26T11:44:43.709845,0,1852,1.0,10,3.9
2025-08-26T11:44:44.210143,0,1852,1.0,10,4.3
2025-08-26T11:44:44.710428,0,1852,1.0,10,4.0
2025-08-26T11:44:45.211000,0,1852,1.0,10,3.6
2025-08-26T11:44:45.711356,0,1852,1.0,10,4.1
2025-08-26T11:44:46.211604,0,1852,1.0,10,4.0
2025-08-26T11:44:46.712130,0,1852,1.0,10,3.8
2025-08-26T11:44:47.212439,0,1852,1.0,10,4.1
2025-08-26T11:44:47.712690,0,1852,1.0,10,3.8
2025-08-26T11:44:48.213220,0,1852,1.0,10,3.7
2025-08-26T11:44:48.713513,0,1852,1.0,10,3.8
2025-08-26T11:44:49.213754,0,1852,1.0,10,3.7
2025-08-26T11:44:49.714363,0,1852,1.0,10,3.7
2025-08-26T11:44:50.214701,0,1852,1.0,10,3.9
2025-08-26T11:44:50.714939,0,1852,1.0,10,3.9
2025-08-26T11:44:51.215519,0,1852,1.0,10,3.7
2025-08-26T11:44:51.715938,0,1852,1.0,10,3.8
2025-08-26T11:44:52.216208,0,1852,1.0,10,4.0
2025-08-26T11:44:52.716445,0,1852,1.0,10,4.4
2025-08-26T11:44:53.216957,0,1852,1.0,10,3.6
2025-08-26T11:44:53.717267,0,1852,1.0,10,4.1
2025-08-26T11:44:54.217504,0,1852,1.0,10,3.9
2025-08-26T11:44:54.718025,0,1852,1.0,10,3.5
2025-08-26T11:44:55.218367,0,1852,1.0,10,4.0
2025-08-26T11:44:55.718612,0,1852,1.0,10,3.9
2025-08-26T11:44:56.219232,0,1852,1.0,10,3.7
2025-08-26T11:44:56.719525,0,1852,1.0,10,4.4
2025-08-26T11:44:57.219970,0,1852,1.0,10,4.2
2025-08-26T11:44:57.720248,0,1852,1.0,10,4.1
2025-08-26T11:44:58.220504,0,1852,1.0,10,4.0
2025-08-26T11:44:58.720756,0,1852,1.0,10,4.2
2025-08-26T11:44:59.220990,0,1852,1.0,10,3.6
2025-08-26T11:44:59.721241,0,1852,1.0,10,3.9
2025-08-26T11:45:00.221529,0,1852,1.0,10,3.8
2025-08-26T11:45:00.722064,0,1852,1.0,10,4.0
2025-08-26T11:45:01.222385,0,1852,1.0,10,4.0
2025-08-26T11:45:01.722682,0,1852,1.0,10,4.1
2025-08-26T11:45:02.223225,0,1852,1.0,10,3.5
2025-08-26T11:45:02.723533,0,1852,1.0,10,4.4
2025-08-26T11:45:03.223829,0,1852,1.0,10,4.1
2025-08-26T11:45:03.724173,0,1852,1.0,10,4.0
2025-08-26T11:45:04.224467,0,1852,1.0,10,4.0
2025-08-26T11:45:04.724745,0,1852,1.0,10,4.2
2025-08-26T11:45:05.224997,0,1852,1.0,10,4.0
2025-08-26T11:45:05.725560,0,1852,1.0,10,4.0
2025-08-26T11:45:06.225883,0,1852,1.0,10,3.9
2025-08-26T11:45:06.726138,0,1852,1.0,10,4.1
2025-08-26T11:45:07.226660,0,1852,1.0,10,3.8
2025-08-26T11:45:07.726969,0,1852,1.0,10,4.4
2025-08-26T11:45:08.227228,0,1852,1.0,10,3.9
2025-08-26T11:45:08.728015,0,1852,1.0,10,4.6
2025-08-26T11:45:09.228258,0,1852,1.0,10,4.0
2025-08-26T11:45:09.728583,0,1852,1.0,10,3.8
2025-08-26T11:45:10.228845,0,1852,1.0,10,3.8
2025-08-26T11:45:10.729092,0,1852,1.0,10,4.4
2025-08-26T11:45:11.229384,0,1852,1.0,10,4.0
2025-08-26T11:45:11.729815,0,1852,1.0,10,4.3
2025-08-26T11:45:12.230126,0,1852,1.0,10,4.2
2025-08-26T11:45:12.730356,0,1852,1.0,10,4.6
2025-08-26T11:45:13.230666,0,1852,1.0,10,4.1
2025-08-26T11:45:13.730938,0,1852,1.0,10,3.9
2025-08-26T11:45:14.231199,0,1852,1.0,10,3.9
2025-08-26T11:45:14.731450,0,1852,1.0,10,4.4
2025-08-26T11:45:15.231695,0,1852,1.0,10,3.7
2025-08-26T11:45:15.731938,0,1852,1.0,10,6.6
2025-08-26T11:45:16.232450,0,1852,1.0,10,4.4
2025-08-26T11:45:16.733035,0,1852,1.0,10,3.9
2025-08-26T11:45:17.233347,0,1852,1.0,10,3.8
2025-08-26T11:45:17.733729,0,1852,1.0,10,3.7
2025-08-26T11:45:18.234182,0,1852,1.0,10,3.6
2025-08-26T11:45:18.734447,0,1852,1.0,10,3.9
2025-08-26T11:45:19.234698,0,1852,1.0,10,4.0
2025-08-26T11:45:19.735009,0,1852,1.0,10,3.9
2025-08-26T11:45:20.235263,0,1852,1.0,10,3.8
2025-08-26T11:45:20.735623,0,1852,1.0,10,3.8
2025-08-26T11:45:21.236169,0,1852,1.0,10,3.8
2025-08-26T11:45:21.736467,0,1852,1.0,10,3.9
2025-08-26T11:45:22.236781,0,1852,1.0,10,4.1
2025-08-26T11:45:22.737105,0,1852,1.0,10,3.8
2025-08-26T11:45:23.237367,0,1852,1.0,10,3.8
2025-08-26T11:45:23.737595,0,1852,1.0,10,4.2
2025-08-26T11:45:24.238113,0,1852,1.0,10,3.7
2025-08-26T11:45:24.738385,0,1852,1.0,10,3.9
2025-08-26T11:45:25.238618,0,1852,1.0,10,4.1
2025-08-26T11:45:25.739125,0,1852,1.0,10,3.8
2025-08-26T11:45:26.239436,0,1852,1.0,10,4.1
2025-08-26T11:45:26.739689,0,1852,1.0,10,3.9
2025-08-26T11:45:27.240335,0,1852,1.0,10,3.8
2025-08-26T11:45:27.740651,0,1852,1.0,10,3.9
2025-08-26T11:45:28.240904,0,1852,1.0,10,3.9
2025-08-26T11:45:28.741314,0,1852,1.0,10,4.3
2025-08-26T11:45:29.241598,0,1852,1.0,10,3.7
2025-08-26T11:45:29.741829,0,1852,1.0,10,3.9
2025-08-26T11:45:30.242508,0,1852,1.0,10,3.4
2025-08-26T11:45:30.742825,0,1852,1.0,10,4.3
2025-08-26T11:45:31.243127,0,1852,1.0,10,3.9
2025-08-26T11:45:31.743667,0,1852,1.0,10,3.9
2025-08-26T11:45:32.244003,0,1852,1.0,10,4.2
2025-08-26T11:45:32.744202,0,1852,1.0,10,3.9
2025-08-26T11:45:33.244818,0,1852,1.0,10,3.5
2025-08-26T11:45:33.745155,0,1852,1.0,10,4.3
2025-08-26T11:45:34.245405,0,1852,1.0,10,4.1
2025-08-26T11:45:34.745931,0,1852,1.0,10,4.2
2025-08-26T11:45:35.246245,0,1852,1.0,10,4.1
2025-08-26T11:45:35.746533,0,1852,1.0,10,3.9
2025-08-26T11:45:36.246822,0,1852,1.0,10,4.2
2025-08-26T11:45:36.747360,0,1852,1.0,10,3.6
2025-08-26T11:45:37.247660,0,1852,1.0,10,4.2
2025-08-26T11:45:37.747901,0,1852,1.0,10,3.6
2025-08-26T11:45:38.248163,0,1852,1.0,10,4.1
2025-08-26T11:45:38.748404,0,1852,1.0,10,4.1
2025-08-26T11:45:39.248908,0,1852,1.0,10,3.4
2025-08-26T11:45:39.749229,0,1852,1.0,10,4.1
2025-08-26T11:45:40.249483,0,1852,1.0,10,3.9
2025-08-26T11:45:40.749811,0,1852,1.0,10,4.1
2025-08-26T11:45:41.250378,0,1852,1.0,10,4.6
2025-08-26T11:45:41.750759,0,1852,1.0,10,4.3
2025-08-26T11:45:42.251175,0,1852,1.0,10,4.1
2025-08-26T11:45:42.751524,0,1852,1.0,10,3.9
2025-08-26T11:45:43.251907,0,1852,1.0,10,5.3
2025-08-26T11:45:43.752371,0,1852,1.0,10,3.9
2025-08-26T11:45:44.252627,0,1852,1.0,10,3.9
2025-08-26T11:45:44.752983,0,1852,1.0,10,4.0
2025-08-26T11:45:45.253411,0,1852,1.0,10,4.0
2025-08-26T11:45:45.753688,0,1852,1.0,10,4.3
2025-08-26T11:45:46.253940,0,1852,1.0,10,4.0
2025-08-26T11:45:46.754532,0,1852,1.0,10,3.8
2025-08-26T11:45:47.254962,0,1852,1.0,10,4.1
2025-08-26T11:45:47.755266,0,1852,1.0,10,4.1
2025-08-26T11:45:48.256219,0,1852,1.0,10,3.6
2025-08-26T11:45:48.756713,0,1852,1.0,10,3.9
2025-08-26T11:45:49.257123,0,1852,1.0,10,3.8
2025-08-26T11:45:49.757505,0,1852,1.0,10,3.8
2025-08-26T11:45:50.257831,0,1852,1.0,10,3.6
2025-08-26T11:45:50.758250,0,1852,1.0,10,4.1
2025-08-26T11:45:51.258644,0,1852,1.0,10,5.1
2025-08-26T11:45:51.759033,0,1852,1.0,10,3.8
2025-08-26T11:45:52.259334,0,1852,1.0,10,4.0
2025-08-26T11:45:52.759869,0,1852,1.0,10,3.8
2025-08-26T11:45:53.260286,0,1852,1.0,10,3.6
2025-08-26T11:45:53.760672,0,1852,1.0,10,4.0
2025-08-26T11:45:54.261476,0,1852,1.0,10,3.8
2025-08-26T11:45:54.761827,0,1852,1.0,10,4.0
2025-08-26T11:45:55.262200,0,1852,1.0,10,4.3
2025-08-26T11:45:55.762988,0,1852,1.0,10,4.1
2025-08-26T11:45:56.263563,0,1852,1.0,10,4.1
2025-08-26T11:45:56.763848,0,1852,1.0,10,4.6
2025-08-26T11:45:57.264218,0,1852,1.0,10,4.0
2025-08-26T11:45:57.764636,0,1852,1.0,10,4.0
2025-08-26T11:45:58.264919,0,1852,1.0,10,4.3
2025-08-26T11:45:58.765176,0,1852,1.0,10,3.9
2025-08-26T11:45:59.265673,0,1852,1.0,10,3.9
2025-08-26T11:45:59.765989,0,1852,1.0,10,4.1
2025-08-26T11:46:00.266243,0,1852,1.0,10,4.4
2025-08-26T11:46:00.766759,0,1852,1.0,10,3.7
2025-08-26T11:46:01.267056,0,1852,1.0,10,4.3
2025-08-26T11:46:01.767282,0,1852,1.0,10,4.2
2025-08-26T11:46:02.267822,0,1852,1.0,10,3.6
2025-08-26T11:46:02.768133,0,1852,1.0,10,4.2
2025-08-26T11:46:03.268380,0,1852,1.0,10,3.9
2025-08-26T11:46:03.768915,0,1852,1.0,10,4.1
2025-08-26T11:46:04.269220,0,1852,1.0,10,4.0
2025-08-26T11:46:04.769445,0,1852,1.0,10,4.0
2025-08-26T11:46:05.269887,0,1852,1.0,10,3.6
2025-08-26T11:46:05.770148,0,1852,1.0,10,3.9
2025-08-26T11:46:06.270455,0,1852,1.0,10,3.7
2025-08-26T11:46:06.770769,0,1852,1.0,10,3.8
2025-08-26T11:46:07.271029,0,1852,1.0,10,3.8
2025-08-26T11:46:07.771395,0,1852,1.0,10,3.7
2025-08-26T11:46:08.271811,0,1852,1.0,10,3.8
2025-08-26T11:46:08.772080,0,1852,1.0,10,4.2
2025-08-26T11:46:09.272324,0,1852,1.0,10,3.9
2025-08-26T11:46:09.772876,0,1852,1.0,10,3.9
2025-08-26T11:46:10.273304,0,1852,1.0,10,4.2
2025-08-26T11:46:10.773527,0,1852,1.0,10,4.0
2025-08-26T11:46:11.274018,0,1852,1.0,10,4.1
2025-08-26T11:46:11.774371,0,1852,1.0,10,3.8
2025-08-26T11:46:12.274646,0,1852,1.0,10,4.0
2025-08-26T11:46:12.775203,0,1852,1.0,10,4.3
2025-08-26T11:46:13.275541,0,1852,1.0,10,3.9
2025-08-26T11:46:13.775807,0,1852,1.0,10,4.0
2025-08-26T11:46:14.276070,0,1852,1.0,10,3.7
2025-08-26T11:46:14.776317,0,1852,1.0,10,3.9
2025-08-26T11:46:15.276583,0,1852,1.0,10,4.0
2025-08-26T11:46:15.777143,0,1852,1.0,10,3.5
2025-08-26T11:46:16.277441,0,1852,1.0,10,3.9
2025-08-26T11:46:16.777828,0,1852,1.0,10,3.6
2025-08-26T11:46:17.278109,0,1852,1.0,10,3.8
2025-08-26T11:46:17.778360,0,1852,1.0,10,3.9
2025-08-26T11:46:18.278895,0,1852,1.0,10,3.8
2025-08-26T11:46:18.779263,0,1852,1.0,10,3.9
2025-08-26T11:46:19.279510,0,1852,1.0,10,3.9
2025-08-26T11:46:19.780035,0,1852,1.0,10,3.6
2025-08-26T11:46:20.280351,0,1852,1.0,10,4.1
2025-08-26T11:46:20.780586,0,1852,1.0,10,3.9
2025-08-26T11:46:21.281069,0,1852,1.0,10,3.9
2025-08-26T11:46:21.781399,0,1852,1.0,10,4.1
2025-08-26T11:46:22.281670,0,1852,1.0,10,4.0
2025-08-26T11:46:22.781906,0,1852,1.0,10,3.7
2025-08-26T11:46:23.282177,0,1852,1.0,10,3.8
2025-08-26T11:46:23.782404,0,1852,1.0,10,4.1
2025-08-26T11:46:24.282621,0,1852,1.0,10,3.6
2025-08-26T11:46:24.782861,0,1852,1.0,10,4.1
2025-08-26T11:46:25.283114,0,1852,1.0,10,4.0
2025-08-26T11:46:25.783592,0,1852,1.0,10,3.8
2025-08-26T11:46:26.283888,0,1852,1.0,10,4.0
2025-08-26T11:46:26.784127,0,1852,1.0,10,3.8
2025-08-26T11:46:27.284605,0,1852,1.0,10,3.4
2025-08-26T11:46:27.784904,0,1852,1.0,10,4.1
2025-08-26T11:46:28.285306,0,1852,1.0,10,4.2
2025-08-26T11:46:28.785846,0,1852,1.0,10,4.0
2025-08-26T11:46:29.286186,0,1852,1.0,10,4.1
2025-08-26T11:46:29.786449,0,1852,1.0,10,3.9
2025-08-26T11:46:30.286881,0,1852,1.0,10,3.9
2025-08-26T11:46:30.787525,0,1852,1.0,10,3.8
2025-08-26T11:46:31.287834,0,1852,1.0,10,4.1
2025-08-26T11:46:31.788114,0,1852,1.0,10,3.8
2025-08-26T11:46:32.288343,0,1852,1.0,10,3.7
2025-08-26T11:46:32.788577,0,1852,1.0,10,4.2
2025-08-26T11:46:33.288825,0,1852,1.0,10,4.1
2025-08-26T11:46:33.789331,0,1852,1.0,10,6.0
2025-08-26T11:46:34.289645,0,1852,1.0,10,4.3
2025-08-26T11:46:34.789957,0,1852,1.0,10,4.0
2025-08-26T11:46:35.290644,0,1852,1.0,10,3.8
2025-08-26T11:46:35.791037,0,1852,1.0,10,4.3
2025-08-26T11:46:36.291255,0,1852,1.0,10,6.0
2025-08-26T11:46:36.791817,0,1852,1.0,10,4.1
2025-08-26T11:46:37.292430,0,1852,1.0,10,4.1
2025-08-26T11:46:37.792812,0,1852,1.0,10,4.3
2025-08-26T11:46:38.293197,0,1852,1.0,10,4.3
2025-08-26T11:46:38.793993,0,1852,1.0,10,4.1
2025-08-26T11:46:39.294426,0,1852,1.0,10,4.1
2025-08-26T11:46:39.794735,0,1852,1.0,10,4.2
2025-08-26T11:46:40.295582,0,1852,1.0,10,3.6
2025-08-26T11:46:40.795993,0,1852,1.0,10,4.2
2025-08-26T11:46:41.296411,0,1852,1.0,10,4.5
2025-08-26T11:46:41.797221,0,1852,1.0,10,3.8
2025-08-26T11:46:42.297607,0,1852,1.0,10,4.0
2025-08-26T11:46:42.797938,0,1852,1.0,10,3.9
2025-08-26T11:46:43.298798,0,1852,1.0,10,3.6
2025-08-26T11:46:43.799302,0,1852,1.0,10,4.1
2025-08-26T11:46:44.299667,0,1852,1.0,10,3.8
2025-08-26T11:46:44.800449,0,1852,1.0,10,4.0
2025-08-26T11:46:45.300741,0,1852,1.0,10,3.9
2025-08-26T11:46:45.800971,0,1852,1.0,10,4.1
2025-08-26T11:46:46.301332,0,1852,1.0,10,4.1
2025-08-26T11:46:46.801644,0,1852,1.0,10,3.8
2025-08-26T11:46:47.301905,0,1852,1.0,10,4.5
2025-08-26T11:46:47.802270,0,1852,1.0,10,4.0
2025-08-26T11:46:48.302507,0,1852,1.0,10,3.9
2025-08-26T11:46:48.802724,0,1852,1.0,10,4.0
2025-08-26T11:46:49.303020,0,1852,1.0,10,4.1
2025-08-26T11:46:49.803281,0,1852,1.0,10,3.7
2025-08-26T11:46:50.303510,0,1852,1.0,10,3.9
2025-08-26T11:46:50.804013,0,1852,1.0,10,3.8
2025-08-26T11:46:51.304312,0,1852,1.0,10,4.2
2025-08-26T11:46:51.804515,0,1852,1.0,10,3.9
2025-08-26T11:46:52.304988,0,1852,1.0,10,3.6
2025-08-26T11:46:52.805315,0,1852,1.0,10,4.3
2025-08-26T11:46:53.305541,0,1852,1.0,10,4.1
2025-08-26T11:46:53.806057,0,1852,1.0,10,3.8
2025-08-26T11:46:54.306455,0,1852,1.0,10,4.4
2025-08-26T11:46:54.806706,0,1852,1.0,10,3.9
2025-08-26T11:46:55.307305,0,1852,1.0,10,3.6
2025-08-26T11:46:55.807613,0,1852,1.0,10,4.2
2025-08-26T11:46:56.307834,0,1852,1.0,10,4.1
2025-08-26T11:46:56.808367,0,1852,1.0,10,3.8
2025-08-26T11:46:57.308660,0,1852,1.0,10,4.1
2025-08-26T11:46:57.808873,0,1852,1.0,10,4.0
2025-08-26T11:46:58.309359,0,1852,1.0,10,3.4
2025-08-26T11:46:58.809651,0,1852,1.0,10,4.2
2025-08-26T11:46:59.309874,0,1852,1.0,10,4.1
2025-08-26T11:46:59.810405,0,1852,1.0,10,3.8
2025-08-26T11:47:00.310709,0,1852,1.0,10,4.4
2025-08-26T11:47:00.810995,0,1852,1.0,10,4.1
2025-08-26T11:47:01.311492,0,1852,1.0,10,3.5
2025-08-26T11:47:01.811781,0,1852,1.0,10,4.1
2025-08-26T11:47:02.312069,0,1852,1.0,10,4.0
2025-08-26T11:47:02.812587,0,1852,1.0,10,3.6
2025-08-26T11:47:03.312953,0,1852,1.0,10,4.3
2025-08-26T11:47:03.813245,0,1852,1.0,10,4.3
2025-08-26T11:47:04.313731,0,1852,1.0,10,3.4
2025-08-26T11:47:04.814075,0,1852,1.0,10,4.1
2025-08-26T11:47:05.314308,0,1852,1.0,10,4.0
2025-08-26T11:47:05.814856,0,1852,1.0,10,4.1
2025-08-26T11:47:06.315162,0,1852,1.0,10,3.9
2025-08-26T11:47:06.815410,0,1852,1.0,10,4.3
2025-08-26T11:47:07.315884,0,1852,1.0,10,3.5
2025-08-26T11:47:07.816209,0,1852,1.0,10,3.9
2025-08-26T11:47:08.316452,0,1852,1.0,10,4.1
2025-08-26T11:47:08.816912,0,1852,1.0,10,3.9
2025-08-26T11:47:09.317207,0,1852,1.0,10,4.1
2025-08-26T11:47:09.817435,0,1852,1.0,10,4.3
2025-08-26T11:47:10.317957,0,1852,1.0,10,3.7
2025-08-26T11:47:10.818321,0,1852,1.0,10,3.9
2025-08-26T11:47:11.318558,0,1852,1.0,10,4.1
2025-08-26T11:47:11.818824,0,1852,1.0,10,4.5
2025-08-26T11:47:12.319054,0,1852,1.0,10,3.8
2025-08-26T11:47:12.819250,0,1852,1.0,10,4.1
2025-08-26T11:47:13.319467,0,1852,1.0,10,4.4
2025-08-26T11:47:13.819987,0,1852,1.0,10,4.1
2025-08-26T11:47:14.320257,0,1852,1.0,10,4.0
2025-08-26T11:47:14.820494,0,1852,1.0,10,4.1
2025-08-26T11:47:15.320969,0,1852,1.0,10,3.5
2025-08-26T11:47:15.821337,0,1852,1.0,10,3.9
2025-08-26T11:47:16.321569,0,1852,1.0,10,4.2
2025-08-26T11:47:16.822153,0,1852,1.0,10,3.7
2025-08-26T11:47:17.322469,0,1852,1.0,10,4.1
2025-08-26T11:47:17.823800,0,1852,1.0,10,4.3
2025-08-26T11:47:18.324385,0,1852,1.0,10,3.6
2025-08-26T11:47:18.824719,0,1852,1.0,10,4.2
2025-08-26T11:47:19.324956,0,1852,1.0,10,4.0
2025-08-26T11:47:19.825180,0,1852,1.0,10,4.4
2025-08-26T11:47:20.325391,0,1852,1.0,10,3.5
2025-08-26T11:47:20.825627,0,1852,1.0,10,4.4
2025-08-26T11:47:21.326253,0,1852,1.0,10,4.4
2025-08-26T11:47:21.826552,0,1852,1.0,10,3.7
2025-08-26T11:47:22.326786,0,1852,1.0,10,4.0
2025-08-26T11:47:22.827173,0,1852,1.0,10,3.7
2025-08-26T11:47:23.327425,0,1852,1.0,10,3.8
2025-08-26T11:47:23.827671,0,1852,1.0,10,4.3
2025-08-26T11:47:24.328152,0,1852,1.0,10,3.8
2025-08-26T11:47:24.828449,0,1852,1.0,10,3.9
2025-08-26T11:47:25.328699,0,1852,1.0,10,4.1
2025-08-26T11:47:25.829025,0,1852,1.0,10,3.8
2025-08-26T11:47:26.329248,0,1852,1.0,10,4.2
2025-08-26T11:47:26.829470,0,1852,1.0,10,4.0
2025-08-26T11:47:27.329979,0,1852,1.0,10,3.5
2025-08-26T11:47:27.830234,0,1852,1.0,10,3.9
2025-08-26T11:47:28.330742,0,1852,1.0,10,4.0
2025-08-26T11:47:28.831112,0,1852,1.0,10,3.8
2025-08-26T11:47:29.331383,0,1852,1.0,10,4.0
2025-08-26T11:47:29.831695,0,1852,1.0,10,3.8
2025-08-26T11:47:30.331946,0,1852,1.0,10,3.5
2025-08-26T11:47:30.832256,0,1852,1.0,10,4.1
2025-08-26T11:47:31.332477,0,1852,1.0,10,3.8
2025-08-26T11:47:31.832711,0,1852,1.0,10,3.7
2025-08-26T11:47:32.332937,0,1852,1.0,10,4.4
2025-08-26T11:47:32.833162,0,1852,1.0,10,4.3
2025-08-26T11:47:33.333553,0,1852,1.0,10,3.8
2025-08-26T11:47:33.833862,0,1852,1.0,10,6.6
2025-08-26T11:47:34.334137,0,1852,1.0,10,4.3
2025-08-26T11:47:34.834622,0,1852,1.0,10,3.9
2025-08-26T11:47:35.334918,0,1852,1.0,10,4.7
2025-08-26T11:47:35.835200,0,1852,1.0,10,3.9
2025-08-26T11:47:36.335659,0,1852,1.0,10,3.4
2025-08-26T11:47:36.835929,0,1852,1.0,10,4.0
2025-08-26T11:47:37.336163,0,1852,1.0,10,4.1
2025-08-26T11:47:37.836455,0,1852,1.0,10,3.6
2025-08-26T11:47:38.336695,0,1852,1.0,10,3.9
2025-08-26T11:47:38.836938,0,1852,1.0,10,3.8
2025-08-26T11:47:39.337169,0,1852,1.0,10,3.5
2025-08-26T11:47:39.837389,0,1852,1.0,10,4.0
2025-08-26T11:47:40.337854,0,1852,1.0,10,3.7
2025-08-26T11:47:40.838150,0,1852,1.0,10,3.9
2025-08-26T11:47:41.338368,0,1852,1.0,10,4.1
2025-08-26T11:47:41.838837,0,1852,1.0,10,3.9
2025-08-26T11:47:42.339245,0,1852,1.0,10,4.1
2025-08-26T11:47:42.839544,0,1852,1.0,10,4.2
2025-08-26T11:47:43.340066,0,1852,1.0,10,3.6
2025-08-26T11:47:43.840433,0,1852,1.0,10,4.4
2025-08-26T11:47:44.340660,0,1852,1.0,10,3.9
2025-08-26T11:47:44.841191,0,1852,1.0,10,3.5
2025-08-26T11:47:45.341485,0,1852,1.0,10,4.0
2025-08-26T11:47:45.841703,0,1852,1.0,10,4.1
2025-08-26T11:47:46.341969,0,1852,1.0,10,3.9
2025-08-26T11:47:46.842282,0,1852,1.0,10,3.7
2025-08-26T11:47:47.342514,0,1852,1.0,10,4.6
2025-08-26T11:47:47.843065,0,1852,1.0,10,3.6
2025-08-26T11:47:48.343426,0,1852,1.0,10,3.6
2025-08-26T11:47:48.843641,0,1852,1.0,10,5.0
2025-08-26T11:47:49.344142,0,1852,1.0,10,3.8
2025-08-26T11:47:49.844420,0,1852,1.0,10,3.8
2025-08-26T11:47:50.344640,0,1852,1.0,10,4.0
2025-08-26T11:47:50.845186,0,1852,1.0,10,3.8
2025-08-26T11:47:51.345480,0,1852,1.0,10,3.8
2025-08-26T11:47:51.845715,0,1852,1.0,10,5.1
2025-08-26T11:47:52.346365,0,1852,1.0,10,3.9
2025-08-26T11:47:52.846667,0,1852,1.0,10,6.1
2025-08-26T11:47:53.346906,0,1852,1.0,10,4.1
2025-08-26T11:47:53.847409,0,1852,1.0,10,4.5
2025-08-26T11:47:54.347685,0,1852,1.0,10,4.3
2025-08-26T11:47:54.847918,0,1852,1.0,10,4.7
2025-08-26T11:47:55.348257,0,1852,1.0,10,5.3
2025-08-26T11:47:55.848562,0,1852,1.0,10,5.0
2025-08-26T11:47:56.348821,0,1852,1.0,10,4.2
2025-08-26T11:47:56.849133,0,1852,1.0,10,4.6
2025-08-26T11:47:57.349382,0,1852,1.0,10,4.6
2025-08-26T11:47:57.849634,0,1852,1.0,10,4.1
2025-08-26T11:47:58.350194,0,1852,1.0,10,3.6
2025-08-26T11:47:58.850545,0,1852,1.0,10,3.5
2025-08-26T11:47:59.350832,0,1852,1.0,10,3.9
2025-08-26T11:47:59.851399,0,1852,1.0,10,3.8
2025-08-26T11:48:00.351726,0,1852,1.0,10,3.9
2025-08-26T11:48:00.851960,0,1852,1.0,10,4.2
2025-08-26T11:48:01.352263,0,1852,1.0,10,4.2
2025-08-26T11:48:01.852759,0,1852,1.0,10,3.6
2025-08-26T11:48:02.353058,0,1852,1.0,10,3.9
2025-08-26T11:48:02.853261,0,1852,1.0,10,4.0
2025-08-26T11:48:03.353755,0,1852,1.0,10,4.1
2025-08-26T11:48:03.854083,0,1852,1.0,10,4.4
2025-08-26T11:48:04.354354,0,1852,1.0,10,4.2
2025-08-26T11:48:04.854885,0,1852,1.0,10,4.6
2025-08-26T11:48:05.355233,0,1852,1.0,10,4.5
2025-08-26T11:48:05.855511,0,1852,1.0,10,3.9
2025-08-26T11:48:06.356066,0,1852,1.0,10,3.9
2025-08-26T11:48:06.856413,0,1852,1.0,10,4.3
2025-08-26T11:48:07.356697,0,1852,1.0,10,4.1
2025-08-26T11:48:07.856947,0,1852,1.0,10,4.3
2025-08-26T11:48:08.357540,0,1852,1.0,10,3.7
2025-08-26T11:48:08.857861,0,1852,1.0,10,4.2
2025-08-26T11:48:09.358160,0,1852,1.0,10,4.5
2025-08-26T11:48:09.858697,0,1852,1.0,10,3.8
2025-08-26T11:48:10.359000,0,1852,1.0,10,4.0
2025-08-26T11:48:10.859235,0,1852,1.0,10,3.9
2025-08-26T11:48:11.359695,0,1852,1.0,10,3.8
2025-08-26T11:48:11.859993,0,1852,1.0,10,5.0
2025-08-26T11:48:12.360255,0,1852,1.0,10,4.5
2025-08-26T11:48:12.860515,0,1852,1.0,10,5.2
2025-08-26T11:48:13.361063,0,1852,1.0,10,6.6
2025-08-26T11:48:13.861373,0,1852,1.0,10,4.6
2025-08-26T11:48:14.361661,0,1852,1.0,10,4.3
2025-08-26T11:48:14.862247,0,1852,1.0,10,4.1
2025-08-26T11:48:15.362570,0,1852,1.0,10,4.2
2025-08-26T11:48:15.862864,0,1852,1.0,10,3.9
2025-08-26T11:48:16.363409,0,1852,1.0,10,3.5
2025-08-26T11:48:16.863740,0,1852,1.0,10,4.0
2025-08-26T11:48:17.364175,0,1852,1.0,10,3.8
2025-08-26T11:48:17.864494,0,1852,1.0,10,4.5
2025-08-26T11:48:18.364791,0,1852,1.0,10,4.3
2025-08-26T11:48:18.865123,0,1852,1.0,10,4.3
2025-08-26T11:48:19.365579,0,1852,1.0,10,4.1
2025-08-26T11:48:19.865853,0,1852,1.0,10,4.3
2025-08-26T11:48:20.366167,0,1852,1.0,10,3.8
2025-08-26T11:48:20.866628,0,1852,1.0,10,4.9
2025-08-26T11:48:21.366935,0,1852,1.0,10,4.7
2025-08-26T11:48:21.867254,0,1852,1.0,10,4.4
2025-08-26T11:48:22.367878,0,1852,1.0,10,4.1
2025-08-26T11:48:22.868182,0,1852,1.0,10,4.7
2025-08-26T11:48:23.368453,0,1852,1.0,10,4.5
2025-08-26T11:48:23.868823,0,1852,1.0,10,3.9
2025-08-26T11:48:24.369125,0,1852,1.0,10,3.6
2025-08-26T11:48:24.869417,0,1852,1.0,10,4.3
2025-08-26T11:48:25.370028,0,1852,1.0,10,3.7
2025-08-26T11:48:25.870360,0,1852,1.0,10,4.0
2025-08-26T11:48:26.370605,0,1852,1.0,10,4.0
2025-08-26T11:48:26.870880,0,1852,1.0,10,4.6
2025-08-26T11:48:27.371806,0,1852,1.0,10,4.5
2025-08-26T11:48:27.872163,0,1852,1.0,10,4.6
2025-08-26T11:48:28.372435,0,1852,1.0,10,4.4
2025-08-26T11:48:28.873015,0,1852,1.0,10,5.6
2025-08-26T11:48:29.373339,0,1852,1.0,10,4.7
2025-08-26T11:48:29.873580,0,1852,1.0,10,4.1
2025-08-26T11:48:30.374160,0,1852,1.0,10,4.1
2025-08-26T11:48:30.874437,0,1852,1.0,10,5.1
2025-08-26T11:48:31.374680,0,1852,1.0,10,5.1
2025-08-26T11:48:31.874906,0,1852,1.0,10,5.1
2025-08-26T11:48:32.375230,0,1852,1.0,10,5.9
2025-08-26T11:48:32.875528,0,1852,1.0,10,5.5
2025-08-26T11:48:33.375827,0,1852,1.0,10,4.4
2025-08-26T11:48:33.876081,0,1852,1.0,10,6.6
2025-08-26T11:48:34.376615,0,1852,1.0,10,5.6
2025-08-26T11:48:34.876988,0,1852,1.0,10,5.3
2025-08-26T11:48:35.377268,0,1852,1.0,10,5.4
2025-08-26T11:48:35.877592,0,1852,1.0,10,4.6
2025-08-26T11:48:36.378227,0,1852,1.0,10,4.8
2025-08-26T11:48:36.878572,0,1852,1.0,10,4.9
2025-08-26T11:48:37.378863,0,1852,1.0,10,4.4
2025-08-26T11:48:37.879176,0,1852,1.0,10,5.3
2025-08-26T11:48:38.379561,0,1852,1.0,10,5.9
2025-08-26T11:48:38.879900,0,1852,1.0,10,6.5
2025-08-26T11:48:39.380232,0,1852,1.0,10,5.1
2025-08-26T11:48:39.880501,0,1852,1.0,10,4.5
2025-08-26T11:48:40.380741,0,1852,1.0,10,4.8
2025-08-26T11:48:40.881009,0,1852,1.0,10,5.1
2025-08-26T11:48:41.381276,0,1852,1.0,10,5.0
2025-08-26T11:48:41.881786,0,1852,1.0,10,4.4
2025-08-26T11:48:42.382101,0,1852,1.0,10,4.7
2025-08-26T11:48:42.882317,0,1852,1.0,10,4.4
2025-08-26T11:48:43.383144,0,1852,1.0,10,4.3
2025-08-26T11:48:43.883539,0,1852,1.0,10,4.6
2025-08-26T11:48:44.383921,0,1852,1.0,10,4.3
2025-08-26T11:48:44.884793,0,1852,1.0,10,5.1
2025-08-26T11:48:45.385304,0,1852,1.0,10,4.9
2025-08-26T11:48:45.885591,0,1852,1.0,10,5.1
2025-08-26T11:48:46.386442,0,1852,1.0,10,4.2
2025-08-26T11:48:46.886867,0,1852,1.0,10,4.1
2025-08-26T11:48:47.387242,0,1852,1.0,10,4.8
2025-08-26T11:48:47.887475,0,1852,1.0,10,3.6
2025-08-26T11:48:48.387727,0,1852,1.0,10,3.9
2025-08-26T11:48:48.888340,0,1852,1.0,10,3.9
2025-08-26T11:48:49.388637,0,1852,1.0,10,4.0
2025-08-26T11:48:49.888890,0,1852,1.0,10,3.9
2025-08-26T11:48:50.389137,0,1852,1.0,10,4.2
2025-08-26T11:48:50.889356,0,1852,1.0,10,4.1
2025-08-26T11:48:51.389606,0,1852,1.0,10,4.6
2025-08-26T11:48:51.890087,0,1852,1.0,10,4.0
2025-08-26T11:48:52.390400,0,1852,1.0,10,4.6
2025-08-26T11:48:52.890625,0,1852,1.0,10,4.1
2025-08-26T11:48:53.391019,0,1852,1.0,10,3.9
2025-08-26T11:48:53.891328,0,1852,1.0,10,4.3
2025-08-26T11:48:54.391573,0,1852,1.0,10,3.9
2025-08-26T11:48:54.891857,0,1852,1.0,10,3.8
2025-08-26T11:48:55.392156,0,1852,1.0,10,3.5
2025-08-26T11:48:55.892415,0,1852,1.0,10,4.0
2025-08-26T11:48:56.392973,0,1852,1.0,10,3.7
2025-08-26T11:48:56.893225,0,1852,1.0,10,6.0
2025-08-26T11:48:57.393572,0,1852,1.0,10,3.8
2025-08-26T11:48:57.894381,0,1852,1.0,10,3.4
2025-08-26T11:48:58.394772,0,1852,1.0,10,3.5
2025-08-26T11:48:58.895131,0,1852,1.0,10,3.9
2025-08-26T11:48:59.395691,0,1852,1.0,10,3.7
2025-08-26T11:48:59.896210,0,1852,1.0,10,3.7
2025-08-26T11:49:00.396472,0,1852,1.0,10,3.9
2025-08-26T11:49:00.896752,0,1852,1.0,10,4.3
2025-08-26T11:49:01.397111,0,1852,1.0,10,4.6
2025-08-26T11:49:01.897404,0,1852,1.0,10,4.7
2025-08-26T11:49:02.397729,0,1852,1.0,10,4.6
2025-08-26T11:49:02.898574,0,1852,1.0,10,4.0
2025-08-26T11:49:03.398974,0,1852,1.0,10,3.8
2025-08-26T11:49:03.899261,0,1852,1.0,10,4.3
2025-08-26T11:49:04.399991,0,1852,1.0,10,3.5
2025-08-26T11:49:04.900401,0,1852,1.0,10,4.1
2025-08-26T11:49:05.400653,0,1852,1.0,10,3.9
2025-08-26T11:49:05.901205,0,1852,1.0,10,3.8
2025-08-26T11:49:06.401889,0,1852,1.0,10,3.8
2025-08-26T11:49:06.902290,0,1852,1.0,10,4.1
2025-08-26T11:49:07.403164,0,1852,1.0,10,3.3
2025-08-26T11:49:07.903544,0,1852,1.0,10,3.9
2025-08-26T11:49:08.403879,0,1852,1.0,10,3.7
2025-08-26T11:49:08.904473,0,1852,1.0,10,3.8
2025-08-26T11:49:09.404894,0,1852,1.0,10,3.7
2025-08-26T11:49:09.905383,0,1852,1.0,10,4.1
2025-08-26T11:49:10.405647,0,1852,1.0,10,3.6
2025-08-26T11:49:10.905884,0,1852,1.0,10,4.0
2025-08-26T11:49:11.406201,0,1852,1.0,10,3.9
2025-08-26T11:49:11.906619,0,1852,1.0,10,4.3
2025-08-26T11:49:12.406899,0,1852,1.0,10,4.0
2025-08-26T11:49:12.907183,0,1852,1.0,10,4.5
2025-08-26T11:49:13.407410,0,1852,1.0,10,4.0
2025-08-26T11:49:13.907632,0,1852,1.0,10,4.4
2025-08-26T11:49:14.407896,0,1852,1.0,10,4.6
2025-08-26T11:49:14.908304,0,1852,1.0,10,3.9
2025-08-26T11:49:15.408603,0,1852,1.0,10,4.8
2025-08-26T11:49:15.908836,0,1852,1.0,10,4.8
2025-08-26T11:49:16.409388,0,1852,1.0,10,4.7
2025-08-26T11:49:16.909702,0,1852,1.0,10,4.3
2025-08-26T11:49:17.409972,0,1852,1.0,10,4.3
2025-08-26T11:49:17.910376,0,1852,1.0,10,4.3
2025-08-26T11:49:18.410664,0,1852,1.0,10,7.0
2025-08-26T11:49:18.910881,0,1852,1.0,10,5.4
2025-08-26T11:49:19.411182,0,1852,1.0,10,5.0
2025-08-26T11:49:19.911484,0,1852,1.0,10,4.9
2025-08-26T11:49:20.411813,0,1852,1.0,10,4.3
2025-08-26T11:49:20.912071,0,1852,1.0,10,4.7
2025-08-26T11:49:21.412347,0,1852,1.0,10,5.3
2025-08-26T11:49:21.912643,0,1852,1.0,10,5.1
2025-08-26T11:49:22.413265,0,1852,1.0,10,3.8
2025-08-26T11:49:22.913608,0,1852,1.0,10,4.8
2025-08-26T11:49:23.413912,0,1852,1.0,10,4.8
2025-08-26T11:49:23.914269,0,1852,1.0,10,4.9
2025-08-26T11:49:24.414544,0,1852,1.0,10,4.5
2025-08-26T11:49:24.914792,0,1852,1.0,10,4.1
2025-08-26T11:49:25.415389,0,1852,1.0,10,3.5
2025-08-26T11:49:25.915699,0,1852,1.0,10,3.8
2025-08-26T11:49:26.415937,0,1852,1.0,10,3.9
2025-08-26T11:49:26.916467,0,1852,1.0,10,3.8
2025-08-26T11:49:27.416760,0,1852,1.0,10,5.5
2025-08-26T11:49:27.917044,0,1852,1.0,10,4.0
2025-08-26T11:49:28.417542,0,1852,1.0,10,4.1
2025-08-26T11:49:28.917860,0,1852,1.0,10,4.8
2025-08-26T11:49:29.418121,0,1852,1.0,10,4.1
2025-08-26T11:49:29.918370,0,1852,1.0,10,4.4
2025-08-26T11:49:30.418967,0,1852,1.0,10,4.2
2025-08-26T11:49:30.919289,0,1852,1.0,10,4.9
2025-08-26T11:49:31.419569,0,1852,1.0,10,4.3
2025-08-26T11:49:31.920044,0,1852,1.0,10,3.8
2025-08-26T11:49:32.420349,0,1852,1.0,10,4.3
2025-08-26T11:49:32.920600,0,1852,1.0,10,4.1
2025-08-26T11:49:33.420845,0,1852,1.0,10,4.2
2025-08-26T11:49:33.921104,0,1852,1.0,10,4.3
2025-08-26T11:49:34.421411,0,1852,1.0,10,5.1
2025-08-26T11:49:34.921937,0,1852,1.0,10,4.3
2025-08-26T11:49:35.422254,0,1852,1.0,10,4.2
2025-08-26T11:49:35.922504,0,1852,1.0,10,4.1
2025-08-26T11:49:36.423083,0,1852,1.0,10,4.8
2025-08-26T11:49:36.923426,0,1852,1.0,10,3.7
2025-08-26T11:49:37.423673,0,1852,1.0,10,4.1
2025-08-26T11:49:37.924330,0,1852,1.0,10,3.6
2025-08-26T11:49:38.424725,0,1852,1.0,10,5.2
2025-08-26T11:49:38.925024,0,1852,1.0,10,5.7
2025-08-26T11:49:39.425357,0,1852,1.0,10,7.4
2025-08-26T11:49:39.925642,0,1852,1.0,10,5.4
2025-08-26T11:49:40.425883,0,1852,1.0,10,7.5
2025-08-26T11:49:40.926135,0,1852,1.0,10,9.3
2025-08-26T11:49:41.426797,0,1852,1.0,10,5.7
2025-08-26T11:49:41.927129,0,1852,1.0,10,6.3
2025-08-26T11:49:42.427668,0,1852,1.0,10,4.7
2025-08-26T11:49:42.927994,0,1852,1.0,10,4.8
2025-08-26T11:49:43.428257,0,1852,1.0,10,4.0
2025-08-26T11:49:43.928797,0,1852,1.0,10,4.9
2025-08-26T11:49:44.429122,0,1852,1.0,10,5.1
2025-08-26T11:49:44.929380,0,1852,1.0,10,4.9
2025-08-26T11:49:45.429931,0,1852,1.0,10,4.3
2025-08-26T11:49:45.930273,0,1852,1.0,10,5.4
2025-08-26T11:49:46.430597,0,1852,1.0,10,6.2
2025-08-26T11:49:46.931450,0,1852,1.0,10,4.2
2025-08-26T11:49:47.431876,0,1852,1.0,10,4.9
2025-08-26T11:49:47.932351,0,1852,1.0,10,5.0
2025-08-26T11:49:48.433222,0,1852,1.0,10,4.0
2025-08-26T11:49:48.933637,0,1852,1.0,10,4.6
2025-08-26T11:49:49.433995,0,1852,1.0,10,4.3
2025-08-26T11:49:49.934838,0,1852,1.0,10,4.3
2025-08-26T11:49:50.435275,0,1852,1.0,10,4.4
2025-08-26T11:49:50.935532,0,1852,1.0,10,4.6
2025-08-26T11:49:51.435804,0,1852,1.0,10,4.3
2025-08-26T11:49:51.936342,0,1852,1.0,10,4.4
2025-08-26T11:49:52.436675,0,1852,1.0,10,5.0
2025-08-26T11:49:52.936915,0,1852,1.0,10,4.3
2025-08-26T11:49:53.437439,0,1852,1.0,10,4.1
2025-08-26T11:49:53.937738,0,1852,1.0,10,4.4
2025-08-26T11:49:54.437982,0,1852,1.0,10,4.4
2025-08-26T11:49:54.938530,0,1852,1.0,10,4.0
2025-08-26T11:49:55.438865,0,1852,1.0,10,4.3
2025-08-26T11:49:55.939168,0,1852,1.0,10,4.3
2025-08-26T11:49:56.439554,0,1852,1.0,10,3.7
2025-08-26T11:49:56.939823,0,1852,1.0,10,5.4
2025-08-26T11:49:57.440141,0,1852,1.0,10,4.4
2025-08-26T11:49:57.940421,0,1852,1.0,10,3.7
2025-08-26T11:49:58.440718,0,1852,1.0,10,4.4
2025-08-26T11:49:58.941275,0,1852,1.0,10,4.4
2025-08-26T11:49:59.441585,0,1852,1.0,10,3.9
2025-08-26T11:49:59.941821,0,1852,1.0,10,4.0
2025-08-26T11:50:00.442396,0,1852,1.0,10,3.9
2025-08-26T11:50:00.942718,0,1852,1.0,10,4.3
2025-08-26T11:50:01.442983,0,1852,1.0,10,3.7
2025-08-26T11:50:01.943371,0,1852,1.0,10,3.9
2025-08-26T11:50:02.443649,0,1852,1.0,10,3.5
2025-08-26T11:50:02.943876,0,1852,1.0,10,4.0
2025-08-26T11:50:03.444499,0,1852,1.0,10,3.3
2025-08-26T11:50:03.944808,0,1852,1.0,10,3.9
2025-08-26T11:50:04.445135,0,1852,1.0,10,3.9
2025-08-26T11:50:04.945696,0,1852,1.0,10,3.8
2025-08-26T11:50:05.445999,0,1852,1.0,10,4.4
2025-08-26T11:50:05.946242,0,1852,1.0,10,3.8
2025-08-26T11:50:06.446771,0,1852,1.0,10,3.3
2025-08-26T11:50:06.947134,0,1852,1.0,10,4.1
2025-08-26T11:50:07.447376,0,1852,1.0,10,3.9
2025-08-26T11:50:07.947622,0,1852,1.0,10,4.1
2025-08-26T11:50:08.447886,0,1852,1.0,10,3.9
2025-08-26T11:50:08.948222,0,1852,1.0,10,3.8
2025-08-26T11:50:09.448484,0,1852,1.0,10,3.7
2025-08-26T11:50:09.948729,0,1852,1.0,10,4.2
2025-08-26T11:50:10.449288,0,1852,1.0,10,3.9
2025-08-26T11:50:10.949599,0,1852,1.0,10,4.5
2025-08-26T11:50:11.449838,0,1852,1.0,10,3.8
2025-08-26T11:50:11.950187,0,1852,1.0,10,4.4
2025-08-26T11:50:12.450465,0,1852,1.0,10,4.7
2025-08-26T11:50:12.950718,0,1852,1.0,10,4.3
2025-08-26T11:50:13.451354,0,1852,1.0,10,4.6
2025-08-26T11:50:13.951658,0,1852,1.0,10,3.9
2025-08-26T11:50:14.451922,0,1852,1.0,10,4.6
2025-08-26T11:50:14.952470,0,1852,1.0,10,4.1
