timestamp,interval_count,total_count,queue_size,max_queue_size,cpu_percent
2025-07-29T03:04:09.236214,20,20,4.3,10,0.0
2025-07-29T03:04:09.736532,39,59,3.1025641025641026,10,47.1
2025-07-29T03:04:10.236865,29,88,3.0689655172413794,10,36.7
2025-07-29T03:04:10.737198,38,126,3.6052631578947367,10,41.5
2025-07-29T03:04:11.237422,29,155,1.4482758620689655,10,47.8
2025-07-29T03:04:11.737682,29,184,3.6551724137931036,10,43.1
2025-07-29T03:04:12.237996,19,203,3.3157894736842106,10,10.6
2025-07-29T03:04:12.738281,19,222,3.9473684210526314,10,47.7
2025-07-29T03:04:13.238501,20,242,2.8,10,36.1
2025-07-29T03:04:13.738713,28,270,3.857142857142857,10,35.2
2025-07-29T03:04:14.238931,20,290,2.85,10,47.0
2025-07-29T03:04:14.739154,19,309,3.0526315789473686,10,30.3
2025-07-29T03:04:15.239383,19,328,3.1052631578947367,10,47.8
2025-07-29T03:04:15.739617,19,347,3.736842105263158,10,26.9
2025-07-29T03:04:16.239889,20,367,2.9,10,26.8
2025-07-29T03:04:16.740106,19,386,2.8421052631578947,10,34.3
2025-07-29T03:04:17.240324,19,405,3.3157894736842106,10,58.7
2025-07-29T03:04:17.740586,9,414,2.7777777777777777,10,53.4
2025-07-29T03:04:18.240838,20,434,1.55,10,18.8
2025-07-29T03:04:18.741068,9,443,1.7777777777777777,10,33.1
2025-07-29T03:04:19.241299,19,462,1.3157894736842106,10,30.5
2025-07-29T03:04:19.741556,19,481,2.1578947368421053,10,26.1
2025-07-29T03:04:20.241845,19,500,4.368421052631579,10,27.4
2025-07-29T03:04:20.742076,10,510,4.6,10,45.5
2025-07-29T03:04:21.242287,9,519,2.6666666666666665,10,33.5
2025-07-29T03:04:21.742492,19,538,3.3157894736842106,10,27.7
2025-07-29T03:04:22.242744,19,557,1.894736842105263,10,15.3
2025-07-29T03:04:22.742994,10,567,1.3,10,66.8
2025-07-29T03:04:23.243275,19,586,1.736842105263158,10,17.6
2025-07-29T03:04:23.743542,10,596,5.5,10,31.3
2025-07-29T03:04:24.243780,19,615,5.2631578947368425,10,39.8
2025-07-29T03:04:24.743998,19,634,4.368421052631579,10,44.7
2025-07-29T03:04:25.244296,19,653,4.842105263157895,10,8.8
2025-07-29T03:04:25.744523,10,663,4.6,10,41.0
2025-07-29T03:04:26.244757,19,682,4.7894736842105265,10,51.8
2025-07-29T03:04:26.744990,9,691,5.0,10,56.2
2025-07-29T03:04:27.245207,20,711,2.7,10,26.6
2025-07-29T03:04:27.745446,9,720,2.6666666666666665,10,48.1
2025-07-29T03:04:28.245680,19,739,4.2105263157894735,10,10.5
2025-07-29T03:04:28.745902,10,749,2.0,10,53.2
2025-07-29T03:04:29.246167,19,768,3.473684210526316,10,40.6
2025-07-29T03:04:29.746565,9,777,4.111111111111111,10,31.2
2025-07-29T03:04:30.246935,19,796,3.6842105263157894,10,11.9
2025-07-29T03:04:30.747312,10,806,2.5,10,34.7
2025-07-29T03:04:31.247681,15,821,2.933333333333333,10,40.0
2025-07-29T03:04:31.748023,19,840,3.4210526315789473,10,28.7
2025-07-29T03:04:32.248239,9,849,1.5555555555555556,10,39.6
2025-07-29T03:04:32.748489,19,868,1.4210526315789473,10,28.9
2025-07-29T03:04:33.248871,10,878,1.3,10,38.1
2025-07-29T03:04:33.749192,9,887,2.3333333333333335,10,41.3
2025-07-29T03:04:34.249489,19,906,3.3684210526315788,10,29.5
2025-07-29T03:04:34.749914,19,925,1.5789473684210527,10,9.8
2025-07-29T03:04:35.250256,10,935,4.6,10,45.0
2025-07-29T03:04:35.750613,9,944,1.8888888888888888,10,50.3
2025-07-29T03:04:36.250893,19,963,3.3157894736842106,10,24.4
2025-07-29T03:04:36.751277,19,982,2.1052631578947367,10,9.6
2025-07-29T03:04:37.251607,10,992,3.0,10,28.6
2025-07-29T03:04:37.751943,9,1001,5.0,10,42.5
2025-07-29T03:04:38.252211,19,1020,4.368421052631579,10,25.8
2025-07-29T03:04:38.752496,19,1039,3.263157894736842,10,20.3
2025-07-29T03:04:39.252864,10,1049,4.6,10,50.4
2025-07-29T03:04:39.753183,9,1058,1.5555555555555556,10,42.5
2025-07-29T03:04:40.253468,19,1077,4.7894736842105265,10,13.5
2025-07-29T03:04:40.753790,10,1087,1.6,10,50.1
2025-07-29T03:04:41.254073,19,1106,4.2105263157894735,10,14.4
2025-07-29T03:04:41.754402,10,1116,5.5,10,34.6
2025-07-29T03:04:42.254634,9,1125,5.0,10,73.4
2025-07-29T03:04:42.755082,19,1144,2.4210526315789473,10,15.9
2025-07-29T03:04:43.255300,10,1154,2.2,10,35.9
2025-07-29T03:04:43.755525,9,1163,1.4444444444444444,10,54.9
2025-07-29T03:04:44.255795,19,1182,4.7894736842105265,10,29.0
2025-07-29T03:04:44.756025,19,1201,2.5789473684210527,10,27.2
2025-07-29T03:04:45.256333,10,1211,3.8,10,35.5
2025-07-29T03:04:45.756585,19,1230,3.789473684210526,10,32.6
2025-07-29T03:04:46.256831,19,1249,3.0,10,40.4
2025-07-29T03:04:46.757063,9,1258,2.7777777777777777,10,34.1
2025-07-29T03:04:47.261406,20,1278,2.4615384615384617,10,29.1
2025-07-29T03:04:47.762044,9,1287,2.4375,10,29.7
2025-07-29T03:04:48.262275,19,1306,1.9473684210526316,10,21.9
2025-07-29T03:04:48.762577,10,1316,5.5,10,34.5
2025-07-29T03:04:49.262800,19,1335,3.736842105263158,10,35.9
2025-07-29T03:04:49.763016,9,1344,5.0,10,43.3
2025-07-29T03:04:50.263224,19,1363,2.473684210526316,10,18.5
2025-07-29T03:04:50.763451,10,1373,3.8,10,19.9
2025-07-29T03:04:51.263663,19,1392,3.263157894736842,10,32.8
2025-07-29T03:04:51.763950,9,1401,5.0,10,33.2
2025-07-29T03:04:52.264209,19,1420,4.157894736842105,10,13.0
2025-07-29T03:04:52.764486,10,1430,2.6,10,20.7
2025-07-29T03:04:53.264693,19,1449,4.842105263157895,10,41.1
2025-07-29T03:04:53.764916,19,1468,2.3684210526315788,10,26.0
2025-07-29T03:04:54.265131,9,1477,2.4444444444444446,10,35.9
2025-07-29T03:04:54.765359,20,1497,4.0,10,29.7
2025-07-29T03:04:55.265578,9,1506,5.0,10,36.0
2025-07-29T03:04:55.765796,19,1525,5.2631578947368425,10,27.6
2025-07-29T03:04:56.266048,19,1544,5.2631578947368425,10,29.3
2025-07-29T03:04:56.766263,10,1554,4.6,10,31.9
2025-07-29T03:04:57.266444,19,1573,4.7894736842105265,10,35.7
2025-07-29T03:04:57.766721,9,1582,5.0,10,44.6
2025-07-29T03:04:58.266929,19,1601,4.473684210526316,10,27.8
2025-07-29T03:04:58.768338,19,1620,3.736842105263158,10,24.1
2025-07-29T03:04:59.268557,10,1630,1.0,10,37.7
2025-07-29T03:04:59.768783,9,1639,4.111111111111111,10,59.5
2025-07-29T03:05:00.269100,19,1658,3.8421052631578947,10,25.6
2025-07-29T03:05:00.769388,19,1677,1.7894736842105263,10,16.3
2025-07-29T03:05:01.269664,19,1696,4.7894736842105265,10,31.5
2025-07-29T03:05:01.770024,10,1706,5.5,10,50.6
2025-07-29T03:05:02.270272,19,1725,3.0,10,55.4
2025-07-29T03:05:02.770622,10,1735,2.6,10,6.9
2025-07-29T03:05:03.270897,19,1754,1.894736842105263,10,27.2
2025-07-29T03:05:03.771262,19,1773,4.842105263157895,10,31.2
2025-07-29T03:05:04.271610,19,1792,4.842105263157895,10,38.7
2025-07-29T03:05:04.771843,9,1801,4.111111111111111,10,36.5
2025-07-29T03:05:05.334488,19,1820,2.7222222222222223,10,18.1
2025-07-29T03:05:05.834816,10,1830,5.090909090909091,10,32.0
2025-07-29T03:05:06.335044,19,1849,3.736842105263158,10,31.5
2025-07-29T03:05:06.835265,19,1868,5.2631578947368425,10,34.7
2025-07-29T03:05:07.335451,9,1877,5.0,10,26.9
2025-07-29T03:05:07.835678,19,1896,3.5789473684210527,10,23.5
2025-07-29T03:05:08.335933,10,1906,5.5,10,29.7
2025-07-29T03:05:08.836159,19,1925,4.157894736842105,10,54.0
2025-07-29T03:05:09.336439,19,1944,2.210526315789474,10,6.6
2025-07-29T03:05:09.836692,10,1954,2.2,10,39.8
2025-07-29T03:05:10.336905,19,1973,2.1578947368421053,10,35.8
2025-07-29T03:05:10.837122,9,1982,2.111111111111111,10,29.9
2025-07-29T03:05:11.337354,19,2001,4.052631578947368,10,18.5
2025-07-29T03:05:11.837584,19,2020,5.2631578947368425,10,28.4
2025-07-29T03:05:12.337801,10,2030,5.5,10,28.2
2025-07-29T03:05:12.838029,19,2049,5.2631578947368425,10,27.1
2025-07-29T03:05:13.338299,19,2068,5.2631578947368425,10,28.3
2025-07-29T03:05:13.838514,9,2077,5.0,10,31.0
2025-07-29T03:05:14.338740,19,2096,4.7894736842105265,10,25.4
2025-07-29T03:05:14.838958,19,2115,2.6315789473684212,10,10.0
2025-07-29T03:05:15.339187,10,2125,2.6,10,26.8
2025-07-29T03:05:15.839405,9,2134,2.7777777777777777,10,58.9
2025-07-29T03:05:16.339620,19,2153,4.368421052631579,10,29.6
2025-07-29T03:05:16.839862,19,2172,3.9473684210526314,10,27.8
2025-07-29T03:05:17.340100,10,2182,4.6,10,32.9
2025-07-29T03:05:17.840403,19,2201,3.0526315789473686,10,25.7
2025-07-29T03:05:18.340614,9,2210,1.4444444444444444,10,42.3
2025-07-29T03:05:18.840854,19,2229,5.2631578947368425,10,17.8
2025-07-29T03:05:19.341136,19,2248,2.6315789473684212,10,26.5
2025-07-29T03:05:19.841506,10,2258,2.6,10,29.5
2025-07-29T03:05:20.341899,9,2267,4.111111111111111,10,39.1
2025-07-29T03:05:20.842139,19,2286,3.8947368421052633,10,25.3
2025-07-29T03:05:21.342413,19,2305,4.0,10,31.3
2025-07-29T03:05:21.842704,19,2324,4.473684210526316,10,14.6
2025-07-29T03:05:22.342928,10,2334,3.1,10,35.4
2025-07-29T03:05:22.843156,19,2353,4.7894736842105265,10,41.6
2025-07-29T03:05:23.343380,9,2362,2.7777777777777777,10,33.9
2025-07-29T03:05:23.843646,19,2381,3.473684210526316,10,33.0
2025-07-29T03:05:24.343894,10,2391,5.5,10,16.7
2025-07-29T03:05:24.844157,19,2410,5.2631578947368425,10,53.2
2025-07-29T03:05:25.344379,9,2419,2.7777777777777777,10,33.7
2025-07-29T03:05:25.844662,19,2438,4.842105263157895,10,16.2
2025-07-29T03:05:26.344951,19,2457,4.842105263157895,10,34.4
2025-07-29T03:05:26.845163,10,2467,4.6,10,39.9
2025-07-29T03:05:27.345396,19,2486,3.4210526315789473,10,34.1
2025-07-29T03:05:27.845625,19,2505,3.9473684210526314,10,30.9
2025-07-29T03:05:28.345850,9,2514,1.5555555555555556,10,28.5
2025-07-29T03:05:28.846056,19,2533,2.736842105263158,10,31.9
2025-07-29T03:05:29.346277,19,2552,3.9473684210526314,10,29.1
2025-07-29T03:05:29.846505,19,2571,4.368421052631579,10,23.4
2025-07-29T03:05:30.346703,20,2591,2.1,10,42.9
2025-07-29T03:05:30.846919,8,2599,1.875,10,38.1
2025-07-29T03:05:31.347163,20,2619,1.8,10,20.1
2025-07-29T03:05:31.847368,19,2638,2.6842105263157894,10,43.1
2025-07-29T03:05:32.347577,9,2647,2.6666666666666665,10,32.0
2025-07-29T03:05:32.847830,20,2667,1.9,10,31.4
2025-07-29T03:05:33.348084,19,2686,2.210526315789474,10,42.4
2025-07-29T03:05:33.848344,10,2696,5.5,10,4.1
2025-07-29T03:05:34.348572,19,2715,3.4210526315789473,10,33.0
2025-07-29T03:05:34.848828,19,2734,3.4210526315789473,10,46.6
2025-07-29T03:05:35.349061,19,2753,5.2631578947368425,10,21.7
2025-07-29T03:05:35.849409,19,2772,3.4210526315789473,10,16.7
2025-07-29T03:05:36.349727,10,2782,2.6,10,38.8
2025-07-29T03:05:36.850024,19,2801,3.210526315789474,10,48.7
2025-07-29T03:05:37.350328,19,2820,4.157894736842105,10,13.1
2025-07-29T03:05:37.850620,19,2839,4.2105263157894735,10,38.0
2025-07-29T03:05:38.350919,10,2849,5.5,10,24.8
2025-07-29T03:05:38.851281,19,2868,5.2631578947368425,10,26.1
2025-07-29T03:05:39.354495,9,2877,2.6666666666666665,10,27.7
2025-07-29T03:05:39.854800,20,2897,1.95,10,24.9
2025-07-29T03:05:40.355156,18,2915,2.1666666666666665,10,45.3
2025-07-29T03:05:40.855451,19,2934,2.6842105263157894,10,7.3
2025-07-29T03:05:41.355738,20,2954,3.0,10,38.3
2025-07-29T03:05:41.856074,19,2973,5.2631578947368425,10,26.1
2025-07-29T03:05:42.356367,19,2992,1.6842105263157894,10,37.9
2025-07-29T03:05:42.856609,19,3011,2.736842105263158,10,6.8
2025-07-29T03:05:43.356900,19,3030,4.2105263157894735,10,31.6
2025-07-29T03:05:43.857206,10,3040,1.8,10,57.2
2025-07-29T03:05:44.357668,19,3059,5.2631578947368425,10,23.5
2025-07-29T03:05:44.858051,20,3079,1.3,10,16.2
2025-07-29T03:05:45.358445,19,3098,2.526315789473684,10,36.0
2025-07-29T03:05:45.858819,19,3117,3.3157894736842106,10,33.6
2025-07-29T03:05:46.359198,19,3136,3.3157894736842106,10,34.1
2025-07-29T03:05:46.859561,19,3155,2.6315789473684212,10,43.9
2025-07-29T03:05:47.359935,19,3174,2.4210526315789473,10,28.1
2025-07-29T03:05:47.860280,19,3193,4.2105263157894735,10,40.0
2025-07-29T03:05:48.360649,19,3212,3.263157894736842,10,28.7
2025-07-29T03:05:48.861012,19,3231,3.9473684210526314,10,45.3
2025-07-29T03:05:49.361377,8,3239,3.625,10,40.8
2025-07-29T03:05:49.861631,19,3258,2.8947368421052633,10,30.7
2025-07-29T03:05:50.361879,19,3277,4.0,10,18.4
2025-07-29T03:05:50.862129,19,3296,3.4210526315789473,10,42.4
2025-07-29T03:05:51.362356,29,3325,4.137931034482759,10,31.2
2025-07-29T03:05:51.862560,20,3345,4.35,10,46.9
2025-07-29T03:05:52.362780,18,3363,4.555555555555555,10,33.3
2025-07-29T03:05:52.863010,18,3381,3.7222222222222223,10,39.2
2025-07-29T03:05:53.364731,29,3410,2.48,10,25.8
2025-07-29T03:05:53.865021,19,3429,2.8260869565217392,10,24.4
2025-07-29T03:05:54.365249,10,3439,1.1,10,54.4
2025-07-29T03:05:54.865563,19,3458,4.157894736842105,10,31.2
2025-07-29T03:05:55.365796,19,3477,4.473684210526316,10,36.4
2025-07-29T03:05:55.866079,18,3495,3.4444444444444446,10,31.0
2025-07-29T03:05:56.366347,19,3514,2.473684210526316,10,22.2
2025-07-29T03:05:56.866613,10,3524,4.6,10,29.6
2025-07-29T03:05:57.366850,19,3543,2.789473684210526,10,53.5
2025-07-29T03:05:57.867115,19,3562,5.2631578947368425,10,26.2
2025-07-29T03:05:58.367419,19,3581,4.368421052631579,10,31.5
2025-07-29T03:05:58.867646,19,3600,2.6842105263157894,10,56.8
2025-07-29T03:05:59.367896,10,3610,5.5,10,17.6
2025-07-29T03:05:59.868120,19,3629,2.5789473684210527,10,28.3
2025-07-29T03:06:00.368348,19,3648,3.1052631578947367,10,29.7
2025-07-29T03:06:00.868631,19,3667,1.8421052631578947,10,28.6
2025-07-29T03:06:01.368852,19,3686,1.894736842105263,10,60.0
2025-07-29T03:06:01.869051,19,3705,5.2631578947368425,10,13.8
2025-07-29T03:06:02.369265,10,3715,3.2,10,53.5
2025-07-29T03:06:02.869455,19,3734,5.2631578947368425,10,20.8
2025-07-29T03:06:03.369776,20,3754,1.9,10,32.6
2025-07-29T03:06:03.870001,19,3773,3.4210526315789473,10,29.5
2025-07-29T03:06:04.370223,19,3792,3.210526315789474,10,26.1
2025-07-29T03:06:04.877394,19,3811,3.4166666666666665,10,37.3
2025-07-29T03:06:05.377661,10,3821,1.7647058823529411,10,10.1
2025-07-29T03:06:05.877883,19,3840,4.7894736842105265,10,42.1
2025-07-29T03:06:06.378112,19,3859,4.368421052631579,10,29.9
2025-07-29T03:06:06.878336,9,3868,1.4444444444444444,10,40.0
2025-07-29T03:06:07.378668,20,3888,4.15,10,9.6
2025-07-29T03:06:07.878890,19,3907,3.263157894736842,10,52.4
2025-07-29T03:06:08.379122,19,3926,4.2105263157894735,10,6.8
2025-07-29T03:06:08.879451,10,3936,1.3,10,49.6
2025-07-29T03:06:09.379673,19,3955,2.210526315789474,10,18.2
2025-07-29T03:06:09.879931,19,3974,4.842105263157895,10,27.5
2025-07-29T03:06:10.380163,10,3984,1.5,10,50.2
2025-07-29T03:06:10.880448,19,4003,3.1052631578947367,10,24.2
2025-07-29T03:06:11.380720,20,4023,2.7,10,33.4
2025-07-29T03:06:11.880989,9,4032,4.111111111111111,10,43.9
2025-07-29T03:06:12.381243,18,4050,2.388888888888889,10,36.4
2025-07-29T03:06:12.881463,19,4069,4.7894736842105265,10,29.4
2025-07-29T03:06:13.381685,19,4088,1.631578947368421,10,17.0
2025-07-29T03:06:13.881912,20,4108,2.15,10,40.5
2025-07-29T03:06:14.382118,9,4117,3.3333333333333335,10,43.5
2025-07-29T03:06:14.882344,19,4136,3.736842105263158,10,26.3
2025-07-29T03:06:15.382659,19,4155,3.6842105263157894,10,14.1
2025-07-29T03:06:15.883581,19,4174,3.6842105263157894,10,31.9
2025-07-29T03:06:16.383848,20,4194,2.9,10,50.5
2025-07-29T03:06:16.887694,9,4203,4.111111111111111,10,37.4
2025-07-29T03:06:17.388613,19,4222,3.3157894736842106,10,29.4
2025-07-29T03:06:17.889014,20,4242,1.7,10,23.7
2025-07-29T03:06:18.389392,9,4251,3.3333333333333335,10,29.6
2025-07-29T03:06:18.889663,19,4270,3.9473684210526314,10,33.4
2025-07-29T03:06:19.389894,20,4290,3.65,10,22.7
2025-07-29T03:06:19.890111,9,4299,5.0,10,61.4
2025-07-29T03:06:20.390351,20,4319,4.3,10,12.2
2025-07-29T03:06:20.890573,19,4338,4.7894736842105265,10,36.8
2025-07-29T03:06:21.390794,19,4357,2.789473684210526,10,25.6
2025-07-29T03:06:21.891005,8,4365,3.625,10,48.6
2025-07-29T03:06:22.391227,20,4385,3.55,10,16.6
2025-07-29T03:06:22.891456,19,4404,2.5789473684210527,10,29.7
2025-07-29T03:06:23.391664,19,4423,4.0,10,29.2
2025-07-29T03:06:23.897770,19,4442,4.083333333333333,10,33.7
2025-07-29T03:06:24.398025,10,4452,2.0,10,13.5
2025-07-29T03:06:24.898257,18,4470,4.666666666666667,10,47.5
2025-07-29T03:06:25.398538,9,4479,3.3333333333333335,10,35.5
2025-07-29T03:06:25.898737,19,4498,4.2105263157894735,10,34.4
2025-07-29T03:06:26.399022,18,4516,2.5,10,29.0
2025-07-29T03:06:26.899455,20,4536,1.8,10,35.9
2025-07-29T03:06:27.399696,19,4555,4.2105263157894735,10,33.6
2025-07-29T03:06:27.900007,9,4564,5.0,10,29.1
2025-07-29T03:06:28.400236,19,4583,4.2105263157894735,10,22.9
2025-07-29T03:06:28.900565,19,4602,3.3684210526315788,10,27.1
2025-07-29T03:06:29.400872,10,4612,2.6,10,36.8
2025-07-29T03:06:29.901231,19,4631,4.368421052631579,10,25.3
2025-07-29T03:06:30.401518,19,4650,4.7894736842105265,10,33.3
2025-07-29T03:06:30.901803,9,4659,2.7777777777777777,10,36.0
2025-07-29T03:06:31.402108,20,4679,2.2,10,18.6
2025-07-29T03:06:31.902415,19,4698,4.7894736842105265,10,38.4
2025-07-29T03:06:32.402859,9,4707,5.0,10,31.1
2025-07-29T03:06:32.903269,10,4717,2.6,10,16.8
2025-07-29T03:06:33.403550,19,4736,2.6315789473684212,10,40.4
2025-07-29T03:06:33.903766,18,4754,2.7222222222222223,10,46.1
2025-07-29T03:06:34.403982,9,4763,3.3333333333333335,10,36.8
2025-07-29T03:06:34.904203,19,4782,4.157894736842105,10,16.5
2025-07-29T03:06:35.404436,10,4792,5.5,10,25.2
2025-07-29T03:06:35.904647,19,4811,5.2631578947368425,10,33.1
2025-07-29T03:06:36.404860,9,4820,5.0,10,35.9
2025-07-29T03:06:36.905080,19,4839,5.2631578947368425,10,11.5
2025-07-29T03:06:37.405312,10,4849,5.5,10,51.7
2025-07-29T03:06:37.905542,9,4858,5.0,10,35.3
2025-07-29T03:06:38.405775,19,4877,4.0,10,15.1
2025-07-29T03:06:38.906018,19,4896,5.2631578947368425,10,20.5
2025-07-29T03:06:39.406246,10,4906,1.6,10,50.0
2025-07-29T03:06:39.906474,19,4925,5.2631578947368425,10,21.0
2025-07-29T03:06:40.406708,19,4944,3.526315789473684,10,22.3
2025-07-29T03:06:40.906924,10,4954,5.5,10,48.6
2025-07-29T03:06:41.407146,19,4973,4.7894736842105265,10,28.9
2025-07-29T03:06:41.907423,9,4982,4.111111111111111,10,36.8
2025-07-29T03:06:42.407687,19,5001,4.473684210526316,10,23.4
2025-07-29T03:06:42.907890,19,5020,4.368421052631579,10,13.8
2025-07-29T03:06:43.408132,10,5030,2.0,10,32.8
2025-07-29T03:06:43.908367,19,5049,3.3684210526315788,10,46.4
2025-07-29T03:06:44.408660,19,5068,4.7894736842105265,10,12.3
2025-07-29T03:06:44.908875,10,5078,2.0,10,50.1
2025-07-29T03:06:45.409097,19,5097,3.0526315789473686,10,19.2
2025-07-29T03:06:45.909331,10,5107,2.6,10,33.7
2025-07-29T03:06:46.409551,19,5126,5.2631578947368425,10,44.8
2025-07-29T03:06:46.909770,9,5135,5.0,10,38.5
2025-07-29T03:06:47.410009,19,5154,2.3684210526315788,10,17.1
2025-07-29T03:06:47.910243,10,5164,1.0,10,32.8
2025-07-29T03:06:48.410471,19,5183,4.7894736842105265,10,46.1
2025-07-29T03:06:48.911937,9,5192,1.1111111111111112,10,45.0
2025-07-29T03:06:49.412171,10,5202,5.5,10,56.7
2025-07-29T03:06:49.912400,9,5211,4.111111111111111,10,59.1
2025-07-29T03:06:50.412638,20,5231,1.5,10,8.7
2025-07-29T03:06:50.912855,9,5240,1.7777777777777777,10,61.7
2025-07-29T03:06:51.413099,19,5259,2.210526315789474,10,23.7
2025-07-29T03:06:51.913325,10,5269,2.5,10,39.1
2025-07-29T03:06:52.413485,19,5288,2.9473684210526314,10,52.7
2025-07-29T03:06:52.913725,9,5297,5.0,10,33.8
2025-07-29T03:06:53.414051,10,5307,5.5,10,37.4
2025-07-29T03:06:53.914448,19,5326,5.2631578947368425,10,31.1
2025-07-29T03:06:54.414848,9,5335,5.0,10,30.1
2025-07-29T03:06:54.915553,19,5354,3.473684210526316,10,27.8
2025-07-29T03:06:55.415837,19,5373,1.7894736842105263,10,18.9
2025-07-29T03:06:55.916075,10,5383,2.0,10,31.5
2025-07-29T03:06:56.416348,19,5402,1.5789473684210527,10,69.5
2025-07-29T03:06:56.916598,10,5412,1.0,10,23.2
2025-07-29T03:06:57.417488,9,5421,2.3333333333333335,10,51.7
2025-07-29T03:06:57.917760,20,5441,5.5,10,45.3
2025-07-29T03:06:58.417995,19,5460,3.1578947368421053,10,57.0
2025-07-29T03:06:58.918222,10,5470,2.0,10,19.0
2025-07-29T03:06:59.418443,19,5489,2.8947368421052633,10,51.1
2025-07-29T03:06:59.918744,19,5508,2.210526315789474,10,5.0
2025-07-29T03:07:00.419038,10,5518,4.6,10,32.6
2025-07-29T03:07:00.919389,19,5537,2.263157894736842,10,28.1
2025-07-29T03:07:01.419751,9,5546,1.1111111111111112,10,26.2
2025-07-29T03:07:01.920055,19,5565,2.263157894736842,10,20.0
2025-07-29T03:07:02.420262,19,5584,4.0,10,19.2
2025-07-29T03:07:02.920479,10,5594,1.0,10,34.0
2025-07-29T03:07:03.420722,19,5613,3.0526315789473686,10,29.2
2025-07-29T03:07:03.921016,19,5632,4.2105263157894735,10,46.2
2025-07-29T03:07:04.421284,9,5641,4.111111111111111,10,32.0
2025-07-29T03:07:04.921646,20,5661,1.5,10,23.8
2025-07-29T03:07:05.425317,9,5670,5.0,10,53.9
2025-07-29T03:07:05.925567,19,5689,2.473684210526316,10,11.7
2025-07-29T03:07:06.425824,19,5708,5.2631578947368425,10,34.5
2025-07-29T03:07:06.926196,10,5718,3.1,10,38.6
2025-07-29T03:07:07.426583,19,5737,2.6842105263157894,10,42.2
2025-07-29T03:07:07.926880,19,5756,3.0,10,50.6
2025-07-29T03:07:08.427164,19,5775,4.368421052631579,10,8.5
2025-07-29T03:07:08.927520,10,5785,3.2,10,33.7
2025-07-29T03:07:09.427885,19,5804,3.6842105263157894,10,47.5
2025-07-29T03:07:09.928202,19,5823,4.421052631578948,10,10.7
2025-07-29T03:07:10.428584,10,5833,5.5,10,46.7
2025-07-29T03:07:10.928950,19,5852,5.2631578947368425,10,26.5
2025-07-29T03:07:11.429300,19,5871,3.5789473684210527,10,28.5
2025-07-29T03:07:11.929647,9,5880,3.4444444444444446,10,28.5
2025-07-29T03:07:12.429874,19,5899,1.4736842105263157,10,27.7
2025-07-29T03:07:12.930163,19,5918,3.9473684210526314,10,29.5
2025-07-29T03:07:13.430378,20,5938,3.55,10,36.4
2025-07-29T03:07:13.930613,9,5947,5.0,10,38.4
2025-07-29T03:07:14.430932,19,5966,3.6315789473684212,10,17.0
2025-07-29T03:07:14.931216,10,5976,5.5,10,40.1
2025-07-29T03:07:15.431552,19,5995,4.842105263157895,10,38.0
2025-07-29T03:07:15.931888,19,6014,3.0526315789473686,10,50.3
2025-07-29T03:07:16.432182,19,6033,2.473684210526316,10,4.8
2025-07-29T03:07:16.932522,10,6043,4.6,10,32.7
2025-07-29T03:07:17.432890,19,6062,2.9473684210526314,10,38.8
2025-07-29T03:07:17.933179,9,6071,2.2222222222222223,10,26.8
2025-07-29T03:07:18.433572,20,6091,3.15,10,20.6
2025-07-29T03:07:18.933884,19,6110,2.736842105263158,10,38.0
2025-07-29T03:07:19.434249,10,6120,4.6,10,6.9
2025-07-29T03:07:19.934597,19,6139,3.210526315789474,10,47.1
2025-07-29T03:07:20.434845,18,6157,3.1666666666666665,10,11.4
2025-07-29T03:07:20.935093,19,6176,4.2105263157894735,10,25.0
2025-07-29T03:07:21.435320,10,6186,4.6,10,40.5
2025-07-29T03:07:21.935542,19,6205,3.9473684210526314,10,27.2
2025-07-29T03:07:22.435787,19,6224,3.0526315789473686,10,32.0
2025-07-29T03:07:22.936008,9,6233,2.6666666666666665,10,25.5
2025-07-29T03:07:23.436232,19,6252,4.157894736842105,10,33.1
2025-07-29T03:07:23.936450,20,6272,3.4,10,25.6
2025-07-29T03:07:24.436669,9,6281,5.0,10,38.9
2025-07-29T03:07:24.936896,19,6300,2.9473684210526314,10,27.1
2025-07-29T03:07:25.437126,10,6310,2.5,10,30.4
2025-07-29T03:07:25.937360,19,6329,2.8947368421052633,10,51.4
2025-07-29T03:07:26.437581,19,6348,3.263157894736842,10,16.6
2025-07-29T03:07:26.937866,19,6367,5.2631578947368425,10,35.9
2025-07-29T03:07:27.438102,10,6377,5.5,10,38.9
2025-07-29T03:07:27.938331,9,6386,5.0,10,46.5
2025-07-29T03:07:28.438561,19,6405,5.2631578947368425,10,17.6
2025-07-29T03:07:28.938784,10,6415,5.5,10,18.8
2025-07-29T03:07:29.439018,19,6434,5.2631578947368425,10,45.6
2025-07-29T03:07:29.939239,8,6442,4.5,10,46.5
2025-07-29T03:07:30.439458,20,6462,2.3,10,11.1
2025-07-29T03:07:30.939677,18,6480,2.111111111111111,10,61.3
2025-07-29T03:07:31.439906,19,6499,1.6842105263157894,10,12.1
2025-07-29T03:07:31.940141,10,6509,2.5,10,18.4
2025-07-29T03:07:32.440369,19,6528,2.473684210526316,10,34.0
2025-07-29T03:07:32.940591,19,6547,2.9473684210526314,10,32.2
2025-07-29T03:07:33.440832,9,6556,4.111111111111111,10,44.0
2025-07-29T03:07:33.941068,19,6575,3.9473684210526314,10,9.2
2025-07-29T03:07:34.441296,19,6594,1.631578947368421,10,28.7
2025-07-29T03:07:34.941521,10,6604,2.6,10,40.0
2025-07-29T03:07:35.441740,19,6623,3.9473684210526314,10,39.9
2025-07-29T03:07:35.941961,9,6632,2.111111111111111,10,29.6
2025-07-29T03:07:36.442226,19,6651,2.0,10,24.4
2025-07-29T03:07:36.942455,20,6671,1.55,10,30.7
2025-07-29T03:07:37.442661,9,6680,2.2222222222222223,10,34.7
2025-07-29T03:07:37.942909,19,6699,2.210526315789474,10,8.2
2025-07-29T03:07:38.443125,10,6709,2.5,10,76.4
2025-07-29T03:07:38.943365,19,6728,3.789473684210526,10,11.3
2025-07-29T03:07:39.443639,10,6738,5.5,10,37.7
2025-07-29T03:07:39.943850,19,6757,3.263157894736842,10,31.5
2025-07-29T03:07:40.444082,9,6766,2.3333333333333335,10,33.2
2025-07-29T03:07:40.944302,20,6786,2.0,10,15.8
2025-07-29T03:07:41.444542,19,6805,3.9473684210526314,10,36.6
2025-07-29T03:07:41.944760,9,6814,5.0,10,46.1
2025-07-29T03:07:42.444983,19,6833,5.2631578947368425,10,22.1
2025-07-29T03:07:42.945209,10,6843,4.6,10,37.8
2025-07-29T03:07:43.445446,19,6862,4.421052631578948,10,33.6
2025-07-29T03:07:43.945678,9,6871,5.0,10,56.6
2025-07-29T03:07:44.445924,19,6890,4.842105263157895,10,24.2
2025-07-29T03:07:44.946287,10,6900,5.5,10,16.7
2025-07-29T03:07:45.446664,19,6919,5.2631578947368425,10,47.2
2025-07-29T03:07:45.947009,19,6938,4.842105263157895,10,34.2
2025-07-29T03:07:46.447299,9,6947,5.0,10,40.6
2025-07-29T03:07:46.947970,19,6966,5.2631578947368425,10,26.3
2025-07-29T03:07:47.448366,10,6976,3.4,10,30.5
2025-07-29T03:07:47.948605,19,6995,5.2631578947368425,10,34.0
2025-07-29T03:07:48.448812,18,7013,2.5555555555555554,10,30.1
2025-07-29T03:07:48.949035,9,7022,1.5555555555555556,10,32.2
2025-07-29T03:07:49.449332,20,7042,2.05,10,20.2
2025-07-29T03:07:49.949628,9,7051,4.111111111111111,10,40.7
2025-07-29T03:07:50.453347,19,7070,3.0526315789473686,10,22.8
2025-07-29T03:07:50.953688,20,7090,2.35,10,33.1
2025-07-29T03:07:51.453975,9,7099,4.111111111111111,10,39.8
2025-07-29T03:07:51.954256,19,7118,3.3157894736842106,10,26.1
2025-07-29T03:07:52.454528,19,7137,3.3684210526315788,10,15.0
2025-07-29T03:07:52.954902,10,7147,1.2,10,62.0
2025-07-29T03:07:53.455179,14,7161,2.857142857142857,10,18.3
2025-07-29T03:07:53.955558,10,7171,5.5,10,32.2
2025-07-29T03:07:54.455882,19,7190,5.2631578947368425,10,31.5
2025-07-29T03:07:54.956547,9,7199,1.2222222222222223,10,50.4
2025-07-29T03:07:55.456860,10,7209,2.1,10,56.0
2025-07-29T03:07:55.957188,19,7228,3.3157894736842106,10,35.9
2025-07-29T03:07:56.457513,19,7247,4.0,10,14.3
2025-07-29T03:07:56.957809,10,7257,4.6,10,39.2
2025-07-29T03:07:57.458229,19,7276,1.894736842105263,10,47.6
2025-07-29T03:07:57.958985,19,7295,3.0,10,5.7
2025-07-29T03:07:58.459295,19,7314,2.263157894736842,10,25.9
2025-07-29T03:07:58.959668,10,7324,4.6,10,49.9
2025-07-29T03:07:59.459963,19,7343,2.3684210526315788,10,29.2
2025-07-29T03:07:59.960245,9,7352,1.6666666666666667,10,35.0
2025-07-29T03:08:00.460587,20,7372,3.05,10,10.4
2025-07-29T03:08:00.960880,19,7391,1.368421052631579,10,53.5
2025-07-29T03:08:01.461173,19,7410,3.6315789473684212,10,4.8
2025-07-29T03:08:01.961535,10,7420,3.8,10,31.1
2025-07-29T03:08:02.461753,18,7438,3.888888888888889,10,37.7
2025-07-29T03:08:02.961990,9,7447,4.111111111111111,10,42.0
2025-07-29T03:08:03.462306,20,7467,1.45,10,12.6
2025-07-29T03:08:03.962584,19,7486,1.1578947368421053,10,38.3
2025-07-29T03:08:04.462814,9,7495,3.3333333333333335,10,39.4
2025-07-29T03:08:04.963031,19,7514,2.8421052631578947,10,25.7
2025-07-29T03:08:05.463268,19,7533,4.2105263157894735,10,26.5
2025-07-29T03:08:05.963437,10,7543,1.7,10,42.5
2025-07-29T03:08:06.463644,19,7562,2.0,10,61.0
2025-07-29T03:08:06.964053,10,7572,4.6,10,4.4
2025-07-29T03:08:07.464369,19,7591,1.7894736842105263,10,28.3
2025-07-29T03:08:07.964648,9,7600,2.7777777777777777,10,31.0
2025-07-29T03:08:08.465012,19,7619,5.2631578947368425,10,18.4
2025-07-29T03:08:08.965415,10,7629,2.6,10,52.1
2025-07-29T03:08:09.465776,19,7648,5.2631578947368425,10,45.3
2025-07-29T03:08:09.971524,9,7657,2.3333333333333335,10,32.3
2025-07-29T03:08:10.471839,10,7667,1.7,10,65.1
2025-07-29T03:08:10.972499,19,7686,2.736842105263158,10,23.8
2025-07-29T03:08:11.472793,10,7696,5.5,10,41.8
2025-07-29T03:08:11.973089,19,7715,1.4210526315789473,10,52.1
2025-07-29T03:08:12.473350,9,7724,3.3333333333333335,10,31.3
2025-07-29T03:08:12.973609,19,7743,3.736842105263158,10,27.1
2025-07-29T03:08:13.473818,10,7753,1.5,10,27.4
2025-07-29T03:08:13.974028,9,7762,4.111111111111111,10,60.2
2025-07-29T03:08:14.474248,19,7781,3.0526315789473686,10,25.3
2025-07-29T03:08:14.974460,10,7791,5.5,10,36.3
2025-07-29T03:08:15.474685,19,7810,2.6842105263157894,10,51.1
2025-07-29T03:08:15.974955,19,7829,3.736842105263158,10,25.9
2025-07-29T03:08:16.475336,19,7848,3.3157894736842106,10,14.9
2025-07-29T03:08:16.975616,10,7858,2.6,10,61.1
2025-07-29T03:08:17.475948,9,7867,4.111111111111111,10,42.8
2025-07-29T03:08:17.976231,19,7886,3.5789473684210527,10,12.2
2025-07-29T03:08:18.476789,19,7905,5.2631578947368425,10,29.2
2025-07-29T03:08:18.977309,10,7915,5.5,10,48.2
2025-07-29T03:08:19.477683,9,7924,2.7777777777777777,10,38.9
2025-07-29T03:08:19.977927,19,7943,2.0526315789473686,10,27.3
2025-07-29T03:08:20.478165,10,7953,3.1,10,58.3
2025-07-29T03:08:20.978399,19,7972,3.0526315789473686,10,26.0
2025-07-29T03:08:21.478629,10,7982,4.6,10,22.8
2025-07-29T03:08:21.978869,19,8001,3.473684210526316,10,40.3
2025-07-29T03:08:22.479093,19,8020,2.3684210526315788,10,43.9
2025-07-29T03:08:22.979366,9,8029,5.0,10,17.6
2025-07-29T03:08:23.479689,10,8039,1.1,10,15.6
2025-07-29T03:08:23.980026,19,8058,3.736842105263158,10,32.4
2025-07-29T03:08:24.480345,9,8067,3.4444444444444446,10,43.9
2025-07-29T03:08:24.980615,19,8086,3.473684210526316,10,21.0
2025-07-29T03:08:25.480951,10,8096,1.7,10,45.4
2025-07-29T03:08:25.981273,9,8105,2.6666666666666665,10,38.6
2025-07-29T03:08:26.482524,19,8124,3.6842105263157894,10,14.3
2025-07-29T03:08:26.982768,19,8143,5.2631578947368425,10,18.9
2025-07-29T03:08:27.482983,10,8153,1.1,10,37.0
2025-07-29T03:08:27.983215,19,8172,3.3684210526315788,10,29.6
2025-07-29T03:08:28.483439,9,8181,5.0,10,26.3
2025-07-29T03:08:28.983715,19,8200,4.842105263157895,10,28.7
2025-07-29T03:08:29.484079,20,8220,5.05,10,24.6
2025-07-29T03:08:29.984447,9,8229,5.0,10,35.5
2025-07-29T03:08:30.484836,19,8248,5.2631578947368425,10,16.7
2025-07-29T03:08:30.985188,19,8267,5.2631578947368425,10,19.8
2025-07-29T03:08:31.485599,10,8277,5.5,10,40.4
2025-07-29T03:08:31.986031,19,8296,3.736842105263158,10,41.5
2025-07-29T03:08:32.486349,9,8305,2.7777777777777777,10,28.3
2025-07-29T03:08:32.986641,10,8315,2.2,10,19.4
2025-07-29T03:08:33.487016,19,8334,3.0526315789473686,10,27.3
2025-07-29T03:08:33.987496,9,8343,2.7777777777777777,10,51.8
2025-07-29T03:08:34.488013,19,8362,1.9473684210526316,10,21.7
2025-07-29T03:08:34.988295,10,8372,3.4,10,51.0
2025-07-29T03:08:35.488593,19,8391,3.8947368421052633,10,38.3
2025-07-29T03:08:35.989480,9,8400,2.7777777777777777,10,37.2
2025-07-29T03:08:36.489789,19,8419,4.157894736842105,10,25.5
2025-07-29T03:08:36.990083,10,8429,4.6,10,43.9
2025-07-29T03:08:37.496491,19,8448,3.6315789473684212,10,28.8
2025-07-29T03:08:37.996822,9,8457,5.0,10,30.7
2025-07-29T03:08:38.497090,10,8467,5.5,10,14.5
2025-07-29T03:08:38.997416,19,8486,5.2631578947368425,10,41.5
2025-07-29T03:08:39.497670,9,8495,5.0,10,45.8
2025-07-29T03:08:39.997917,20,8515,3.3,10,26.3
2025-07-29T03:08:40.498162,9,8524,5.0,10,47.3
2025-07-29T03:08:40.998377,19,8543,5.2631578947368425,10,16.6
2025-07-29T03:08:41.498626,19,8562,5.2631578947368425,10,15.3
2025-07-29T03:08:41.998838,10,8572,5.5,10,25.6
2025-07-29T03:08:42.499124,9,8581,5.0,10,41.6
2025-07-29T03:08:42.999428,20,8601,2.05,10,13.7
2025-07-29T03:08:43.499798,19,8620,2.1578947368421053,10,45.8
2025-07-29T03:08:44.001126,9,8629,3.3333333333333335,10,40.6
2025-07-29T03:08:44.501361,19,8648,5.2631578947368425,10,31.8
2025-07-29T03:08:45.001590,19,8667,5.2631578947368425,10,11.8
2025-07-29T03:08:45.501807,10,8677,2.0,10,24.3
2025-07-29T03:08:46.002089,19,8696,5.2631578947368425,10,31.8
2025-07-29T03:08:46.502333,9,8705,2.6666666666666665,10,51.0
2025-07-29T03:08:47.002610,19,8724,5.2631578947368425,10,17.8
2025-07-29T03:08:47.502850,10,8734,5.5,10,40.4
2025-07-29T03:08:48.003043,19,8753,3.473684210526316,10,36.3
2025-07-29T03:08:48.503258,9,8762,5.0,10,33.6
2025-07-29T03:08:49.003526,19,8781,5.2631578947368425,10,23.7
2025-07-29T03:08:49.511451,19,8800,5.055555555555555,10,11.8
2025-07-29T03:08:50.011689,10,8810,5.090909090909091,10,32.8
2025-07-29T03:08:50.511902,9,8819,3.4444444444444446,10,46.6
2025-07-29T03:08:51.012125,19,8838,3.5789473684210527,10,28.8
2025-07-29T03:08:51.512482,10,8848,1.3,10,41.9
2025-07-29T03:08:52.012713,19,8867,4.0,10,16.7
2025-07-29T03:08:52.512984,10,8877,3.9,10,39.4
2025-07-29T03:08:53.013219,9,8886,2.0,10,35.2
2025-07-29T03:08:53.513443,19,8905,4.842105263157895,10,28.1
2025-07-29T03:08:54.013692,19,8924,5.2631578947368425,10,8.0
2025-07-29T03:08:54.513953,10,8934,5.5,10,35.0
2025-07-29T03:08:55.014231,19,8953,1.6842105263157894,10,48.1
2025-07-29T03:08:55.514493,10,8963,5.5,10,4.7
2025-07-29T03:08:56.014714,19,8982,3.4210526315789473,10,35.3
2025-07-29T03:08:56.514937,9,8991,5.0,10,37.7
2025-07-29T03:08:57.015207,19,9010,3.0526315789473686,10,8.6
2025-07-29T03:08:57.515631,19,9029,3.6842105263157894,10,25.0
2025-07-29T03:08:58.016153,10,9039,5.5,10,38.7
2025-07-29T03:08:58.516495,19,9058,5.2631578947368425,10,50.1
2025-07-29T03:08:59.016737,9,9067,5.0,10,36.6
2025-07-29T03:08:59.516970,19,9086,1.5789473684210527,10,26.7
2025-07-29T03:09:00.017241,10,9096,3.8,10,42.7
2025-07-29T03:09:00.517457,19,9115,4.7894736842105265,10,38.5
2025-07-29T03:09:01.017653,19,9134,4.368421052631579,10,28.7
2025-07-29T03:09:01.517863,9,9143,1.2222222222222223,10,32.4
2025-07-29T03:09:02.018080,10,9153,4.6,10,22.3
2025-07-29T03:09:02.518301,19,9172,4.368421052631579,10,48.3
2025-07-29T03:09:03.018521,9,9181,5.0,10,36.9
2025-07-29T03:09:03.518748,19,9200,4.368421052631579,10,12.7
2025-07-29T03:09:04.018972,10,9210,5.5,10,30.4
2025-07-29T03:09:04.519205,19,9229,5.2631578947368425,10,30.1
2025-07-29T03:09:05.019473,9,9238,5.0,10,41.1
2025-07-29T03:09:05.519848,20,9258,2.2,10,23.2
2025-07-29T03:09:06.022536,19,9277,3.263157894736842,10,52.0
2025-07-29T03:09:06.523631,10,9287,2.0,10,5.6
2025-07-29T03:09:07.024082,4,9291,1.75,10,49.2
2025-07-29T03:09:07.527466,19,9310,5.2631578947368425,10,24.7
2025-07-29T03:09:08.027750,19,9329,3.5789473684210527,10,36.2
2025-07-29T03:09:08.528158,10,9339,2.2,10,48.8
2025-07-29T03:09:09.028532,19,9358,3.3157894736842106,10,27.4
2025-07-29T03:09:09.528869,9,9367,5.0,10,46.9
2025-07-29T03:09:10.029167,19,9386,4.157894736842105,10,16.2
2025-07-29T03:09:10.529564,10,9396,2.8,10,24.8
2025-07-29T03:09:11.029908,19,9415,2.736842105263158,10,52.7
2025-07-29T03:09:11.530141,19,9434,2.0,10,11.1
2025-07-29T03:09:12.030365,10,9444,4.6,10,46.7
2025-07-29T03:09:12.530587,19,9463,2.4210526315789473,10,29.5
2025-07-29T03:09:13.030863,9,9472,2.7777777777777777,10,40.4
2025-07-29T03:09:13.531166,20,9492,1.45,10,21.0
2025-07-29T03:09:14.031446,19,9511,3.9473684210526314,10,48.0
2025-07-29T03:09:14.532517,9,9520,2.7777777777777777,10,33.1
2025-07-29T03:09:15.032814,20,9540,3.4,10,37.9
2025-07-29T03:09:15.533113,8,9548,3.625,10,39.6
2025-07-29T03:09:16.033981,19,9567,3.3684210526315788,10,32.9
2025-07-29T03:09:16.534374,18,9585,2.7222222222222223,10,19.7
2025-07-29T03:09:17.034666,10,9595,2.0,10,42.9
2025-07-29T03:09:17.534916,19,9614,2.6315789473684212,10,51.4
2025-07-29T03:09:18.035190,18,9632,2.6666666666666665,10,6.3
2025-07-29T03:09:18.538273,19,9651,3.5714285714285716,10,28.7
2025-07-29T03:09:19.039144,10,9661,3.6,10,47.6
2025-07-29T03:09:19.539440,8,9669,2.25,10,52.9
2025-07-29T03:09:20.039712,19,9688,4.368421052631579,10,18.7
2025-07-29T03:09:20.539924,10,9698,3.4,10,39.8
2025-07-29T03:09:21.040125,19,9717,3.3157894736842106,10,37.7
2025-07-29T03:09:21.540352,9,9726,1.5555555555555556,10,32.6
2025-07-29T03:09:22.040589,10,9736,1.4,10,28.3
2025-07-29T03:09:22.540813,19,9755,4.7894736842105265,10,48.3
2025-07-29T03:09:23.041197,19,9774,2.0526315789473686,10,41.0
2025-07-29T03:09:23.541469,9,9783,4.111111111111111,10,36.0
2025-07-29T03:09:24.041684,19,9802,3.6842105263157894,10,20.7
2025-07-29T03:09:24.541901,19,9821,5.2631578947368425,10,30.0
2025-07-29T03:09:25.042123,10,9831,5.5,10,35.9
2025-07-29T03:09:25.542381,19,9850,3.6842105263157894,10,26.6
2025-07-29T03:09:26.042592,9,9859,5.0,10,29.3
2025-07-29T03:09:26.542905,19,9878,5.2631578947368425,10,21.6
2025-07-29T03:09:27.043118,10,9888,5.5,10,29.0
2025-07-29T03:09:27.543418,19,9907,4.7894736842105265,10,31.2
2025-07-29T03:09:28.043689,9,9916,2.2222222222222223,10,29.5
2025-07-29T03:09:28.543966,19,9935,1.263157894736842,10,26.3
2025-07-29T03:09:29.044183,19,9954,4.842105263157895,10,22.2
2025-07-29T03:09:29.544401,19,9973,4.421052631578948,10,30.6
2025-07-29T03:09:30.044613,10,9983,1.5,10,40.3
2025-07-29T03:09:30.544827,19,10002,1.4736842105263157,10,56.1
2025-07-29T03:09:31.045067,10,10012,5.5,10,10.2
2025-07-29T03:09:31.545302,9,10021,1.8888888888888888,10,46.9
2025-07-29T03:09:32.046054,19,10040,3.0,10,18.4
2025-07-29T03:09:32.546271,10,10050,2.6,10,36.2
2025-07-29T03:09:33.046440,19,10069,3.1052631578947367,10,26.2
2025-07-29T03:09:33.546661,9,10078,1.5555555555555556,10,40.3
2025-07-29T03:09:34.047021,19,10097,1.894736842105263,10,17.7
2025-07-29T03:09:34.547305,19,10116,4.7894736842105265,10,30.5
2025-07-29T03:09:35.047669,10,10126,2.1,10,44.6
2025-07-29T03:09:35.548029,19,10145,2.263157894736842,10,41.1
2025-07-29T03:09:36.048412,9,10154,2.2222222222222223,10,44.5
2025-07-29T03:09:36.549477,19,10173,4.0,10,30.8
2025-07-29T03:09:37.049793,10,10183,4.6,10,61.1
2025-07-29T03:09:37.550116,19,10202,1.631578947368421,10,58.6
2025-07-29T03:09:38.050436,10,10212,5.5,10,14.0
2025-07-29T03:09:38.550735,19,10231,4.421052631578948,10,54.1
2025-07-29T03:09:39.050990,19,10250,5.2631578947368425,10,11.3
2025-07-29T03:09:39.551242,19,10269,1.4736842105263157,10,32.5
2025-07-29T03:09:40.051456,10,10279,5.5,10,45.8
2025-07-29T03:09:40.551674,19,10298,4.421052631578948,10,44.6
2025-07-29T03:09:41.051882,19,10317,3.736842105263158,10,5.4
2025-07-29T03:09:41.552112,10,10327,1.6,10,26.1
2025-07-29T03:09:42.052343,19,10346,2.473684210526316,10,32.7
2025-07-29T03:09:42.552554,19,10365,3.1052631578947367,10,48.9
2025-07-29T03:09:43.052770,9,10374,1.4444444444444444,10,32.5
2025-07-29T03:09:43.553046,19,10393,2.3684210526315788,10,20.7
2025-07-29T03:09:44.053273,10,10403,2.6,10,41.3
2025-07-29T03:09:44.553457,19,10422,2.0,10,40.2
2025-07-29T03:09:45.053668,9,10431,1.4444444444444444,10,29.3
2025-07-29T03:09:45.553939,19,10450,2.0526315789473686,10,23.6
2025-07-29T03:09:46.054182,14,10464,2.5714285714285716,10,13.5
2025-07-29T03:09:46.554478,10,10474,4.6,10,47.1
2025-07-29T03:09:47.054701,9,10483,4.111111111111111,10,38.7
2025-07-29T03:09:47.554921,19,10502,1.9473684210526316,10,28.8
2025-07-29T03:09:48.055170,19,10521,2.6842105263157894,10,23.3
2025-07-29T03:09:48.555460,10,10531,5.5,10,21.1
2025-07-29T03:09:49.055764,19,10550,3.3157894736842106,10,43.0
2025-07-29T03:09:49.556009,19,10569,2.473684210526316,10,22.5
2025-07-29T03:09:50.056311,20,10589,3.65,10,34.3
2025-07-29T03:09:50.556538,19,10608,4.7894736842105265,10,28.6
2025-07-29T03:09:51.056748,9,10617,5.0,10,25.4
2025-07-29T03:09:51.557013,19,10636,3.0526315789473686,10,30.7
2025-07-29T03:09:52.057407,10,10646,5.5,10,23.6
2025-07-29T03:09:52.557674,19,10665,2.736842105263158,10,31.3
2025-07-29T03:09:53.057933,19,10684,1.263157894736842,10,28.0
2025-07-29T03:09:53.558216,9,10693,2.0,10,42.8
2025-07-29T03:09:54.060898,19,10712,3.9473684210526314,10,40.9
2025-07-29T03:09:54.561252,20,10732,3.05,10,40.4
2025-07-29T03:09:55.061529,19,10751,4.052631578947368,10,44.0
2025-07-29T03:09:55.562501,9,10760,2.7777777777777777,10,28.8
2025-07-29T03:09:56.062806,10,10770,2.1,10,46.8
2025-07-29T03:09:56.563109,19,10789,2.6842105263157894,10,29.4
2025-07-29T03:09:57.063435,19,10808,1.5263157894736843,10,22.5
2025-07-29T03:09:57.563712,19,10827,2.3684210526315788,10,27.9
2025-07-29T03:09:58.063956,10,10837,3.8,10,43.1
2025-07-29T03:09:58.564192,19,10856,2.526315789473684,10,27.9
2025-07-29T03:09:59.064425,19,10875,2.4210526315789473,10,33.9
2025-07-29T03:09:59.564698,9,10884,2.7777777777777777,10,38.5
2025-07-29T03:10:00.065491,19,10903,3.3157894736842106,10,20.7
2025-07-29T03:10:00.565823,10,10913,4.6,10,28.1
2025-07-29T03:10:01.068579,19,10932,3.8421052631578947,10,51.3
2025-07-29T03:10:01.568873,9,10941,5.0,10,32.3
2025-07-29T03:10:02.069134,19,10960,5.2631578947368425,10,24.0
2025-07-29T03:10:02.569492,10,10970,5.5,10,43.0
2025-07-29T03:10:03.069809,19,10989,3.1052631578947367,10,50.3
2025-07-29T03:10:03.570043,9,10998,1.7777777777777777,10,62.2
2025-07-29T03:10:04.070270,19,11017,1.9473684210526316,10,34.1
2025-07-29T03:10:04.570466,20,11037,3.45,10,26.6
2025-07-29T03:10:05.070679,19,11056,2.0,10,39.6
2025-07-29T03:10:05.570935,9,11065,1.8888888888888888,10,31.0
2025-07-29T03:10:06.071223,19,11084,2.473684210526316,10,10.8
2025-07-29T03:10:06.571459,10,11094,1.7,10,31.5
2025-07-29T03:10:07.071681,19,11113,3.1052631578947367,10,48.3
2025-07-29T03:10:07.571905,19,11132,2.8947368421052633,10,8.0
2025-07-29T03:10:08.072127,10,11142,5.5,10,25.9
2025-07-29T03:10:08.572372,19,11161,2.789473684210526,10,66.7
2025-07-29T03:10:09.077722,19,11180,2.0625,10,36.3
2025-07-29T03:10:09.577959,10,11190,1.6923076923076923,10,79.7
2025-07-29T03:10:10.078233,10,11200,2.8,10,18.3
2025-07-29T03:10:10.578492,19,11219,1.368421052631579,10,55.2
2025-07-29T03:10:11.078710,10,11229,2.1,10,4.8
2025-07-29T03:10:11.578935,19,11248,5.2631578947368425,10,34.5
2025-07-29T03:10:12.079211,9,11257,5.0,10,46.4
2025-07-29T03:10:12.579496,19,11276,5.2631578947368425,10,31.6
2025-07-29T03:10:13.079727,19,11295,3.6842105263157894,10,21.5
2025-07-29T03:10:13.579965,10,11305,3.9,10,25.2
2025-07-29T03:10:14.080229,19,11324,3.6842105263157894,10,49.1
2025-07-29T03:10:14.580432,18,11342,4.333333333333333,10,43.7
2025-07-29T03:10:15.080627,19,11361,3.5789473684210527,10,31.2
2025-07-29T03:10:15.580880,19,11380,2.789473684210526,10,22.9
2025-07-29T03:10:16.081133,10,11390,4.6,10,44.3
2025-07-29T03:10:16.581353,9,11399,1.8888888888888888,10,33.7
2025-07-29T03:10:17.081570,19,11418,1.5789473684210527,10,29.3
2025-07-29T03:10:17.581796,19,11437,4.842105263157895,10,37.9
2025-07-29T03:10:18.082028,19,11456,1.1578947368421053,10,24.0
2025-07-29T03:10:18.582262,19,11475,5.2631578947368425,10,37.4
2025-07-29T03:10:19.082522,10,11485,2.7,10,37.6
2025-07-29T03:10:19.582757,9,11494,4.111111111111111,10,57.5
2025-07-29T03:10:20.083036,19,11513,3.5789473684210527,10,33.7
2025-07-29T03:10:20.583310,29,11542,3.7241379310344827,10,9.1
2025-07-29T03:10:21.083522,10,11552,1.8,10,37.0
2025-07-29T03:10:21.583787,19,11571,5.2631578947368425,10,31.7
2025-07-29T03:10:22.088617,19,11590,5.2631578947368425,10,25.7
2025-07-29T03:10:22.588975,10,11600,3.1,10,43.2
2025-07-29T03:10:23.089348,19,11619,3.1578947368421053,10,43.4
2025-07-29T03:10:23.589577,10,11629,1.4,10,4.8
2025-07-29T03:10:24.089829,19,11648,2.526315789473684,10,47.8
2025-07-29T03:10:24.590059,19,11667,1.4210526315789473,10,46.4
2025-07-29T03:10:25.090288,10,11677,4.6,10,11.8
2025-07-29T03:10:25.590574,19,11696,3.9473684210526314,10,31.8
2025-07-29T03:10:26.090767,19,11715,2.736842105263158,10,42.1
2025-07-29T03:10:26.590991,9,11724,2.6666666666666665,10,29.7
2025-07-29T03:10:27.091204,10,11734,1.4,10,16.2
2025-07-29T03:10:27.591442,19,11753,1.9473684210526316,10,29.3
2025-07-29T03:10:28.091651,14,11767,2.357142857142857,10,39.6
2025-07-29T03:10:28.591874,9,11776,4.111111111111111,10,33.1
2025-07-29T03:10:29.092162,10,11786,5.5,10,28.5
2025-07-29T03:10:29.592475,19,11805,5.2631578947368425,10,40.5
2025-07-29T03:10:30.092776,19,11824,5.2631578947368425,10,27.1
2025-07-29T03:10:30.593054,9,11833,5.0,10,45.1
2025-07-29T03:10:31.093274,19,11852,5.2631578947368425,10,27.8
2025-07-29T03:10:31.593792,19,11871,5.2631578947368425,10,32.9
2025-07-29T03:10:32.093996,10,11881,5.5,10,28.1
2025-07-29T03:10:32.594242,9,11890,2.6666666666666665,10,44.5
2025-07-29T03:10:33.094514,19,11909,5.2631578947368425,10,11.6
2025-07-29T03:10:33.594729,10,11919,2.2,10,44.3
2025-07-29T03:10:34.094942,19,11938,2.1052631578947367,10,30.1
2025-07-29T03:10:34.595169,19,11957,3.473684210526316,10,20.4
2025-07-29T03:10:35.095391,10,11967,1.6,10,23.7
2025-07-29T03:10:35.595603,19,11986,2.8947368421052633,10,54.9
2025-07-29T03:10:36.095808,9,11995,1.4444444444444444,10,44.3
2025-07-29T03:10:36.595998,20,12015,1.25,10,17.4
2025-07-29T03:10:37.096198,19,12034,3.3157894736842106,10,37.4
2025-07-29T03:10:37.596444,9,12043,4.111111111111111,10,33.7
2025-07-29T03:10:38.096805,19,12062,2.5789473684210527,10,12.7
2025-07-29T03:10:38.597184,19,12081,2.0526315789473686,10,31.7
2025-07-29T03:10:39.097568,10,12091,2.1,10,50.2
2025-07-29T03:10:39.597845,19,12110,3.210526315789474,10,26.4
2025-07-29T03:10:40.098257,20,12130,2.75,10,42.0
2025-07-29T03:10:40.599493,9,12139,4.111111111111111,10,33.0
2025-07-29T03:10:41.099720,19,12158,4.7894736842105265,10,27.4
2025-07-29T03:10:41.599953,10,12168,1.9,10,42.1
2025-07-29T03:10:42.100171,19,12187,2.6842105263157894,10,27.9
2025-07-29T03:10:42.600402,20,12207,3.4,10,29.0
2025-07-29T03:10:43.100606,9,12216,1.3333333333333333,10,47.3
2025-07-29T03:10:43.601009,19,12235,1.894736842105263,10,6.9
2025-07-29T03:10:44.101243,10,12245,3.8,10,42.9
2025-07-29T03:10:44.601464,9,12254,1.2222222222222223,10,37.1
2025-07-29T03:10:45.101807,19,12273,3.736842105263158,10,31.6
2025-07-29T03:10:45.602118,19,12292,3.3684210526315788,10,8.8
2025-07-29T03:10:46.102422,10,12302,1.1,10,44.4
2025-07-29T03:10:46.606523,19,12321,5.2631578947368425,10,26.3
2025-07-29T03:10:47.106763,10,12331,2.6,10,32.8
2025-07-29T03:10:47.607041,9,12340,1.6666666666666667,10,46.2
2025-07-29T03:10:48.107398,0,12340,4.0,10,9.8
2025-07-29T03:10:48.607750,0,12340,4.0,10,4.1
2025-07-29T03:10:49.108446,0,12340,4.0,10,7.7
