timestamp,interval_count,total_count,queue_size,max_queue_size,cpu_percent
2025-08-18T12:07:42.302770,20,20,3.1,6,0.0
2025-08-18T12:07:42.803200,55,75,3.8181818181818183,10,6.8
2025-08-18T12:07:43.303566,58,133,4.482758620689655,10,5.9
2025-08-18T12:07:43.803775,43,176,5.255813953488372,10,5.3
2025-08-18T12:07:44.303993,58,234,4.672413793103448,10,5.3
2025-08-18T12:07:44.804269,42,276,3.6666666666666665,10,6.7
2025-08-18T12:07:45.304465,84,360,4.571428571428571,10,6.1
2025-08-18T12:07:45.804718,36,396,2.861111111111111,10,4.9
2025-08-18T12:07:46.305041,69,465,3.9855072463768115,10,5.7
2025-08-18T12:07:46.805293,40,505,3.825,10,5.1
2025-08-18T12:07:47.305627,85,590,1.8588235294117648,10,6.0
2025-08-18T12:07:47.805843,41,631,4.536585365853658,10,4.9
2025-08-18T12:07:48.306115,33,664,3.878787878787879,10,6.1
2025-08-18T12:07:48.806372,9,673,2.7777777777777777,10,4.5
2025-08-18T12:07:49.306615,10,683,3.8,10,3.6
2025-08-18T12:07:49.806842,49,732,3.122448979591837,10,5.9
2025-08-18T12:07:50.307085,18,750,1.6111111111111112,10,4.2
2025-08-18T12:07:50.807315,21,771,3.3333333333333335,10,4.8
2025-08-18T12:07:51.307566,10,781,2.2,10,3.6
2025-08-18T12:07:51.807831,0,781,1.0,10,3.6
2025-08-18T12:07:52.308121,8,789,1.375,10,4.2
2025-08-18T12:07:52.808335,10,799,1.1,10,3.9
2025-08-18T12:07:53.308657,0,799,1.0,10,3.4
2025-08-18T12:07:53.808928,0,799,1.0,10,3.2
2025-08-18T12:07:54.309236,0,799,1.0,10,3.2
2025-08-18T12:07:54.809549,0,799,1.0,10,3.3
2025-08-18T12:07:55.309843,0,799,1.0,10,3.3
2025-08-18T12:07:55.810156,0,799,1.0,10,3.2
2025-08-18T12:07:56.310434,9,808,1.1111111111111112,10,5.0
2025-08-18T12:07:56.810649,0,808,1.0,10,3.5
2025-08-18T12:07:57.310938,10,818,2.6,10,3.3
2025-08-18T12:07:57.811139,0,818,6.0,10,3.3
2025-08-18T12:07:58.311458,2,820,1.0,10,7.6
2025-08-18T12:07:58.811788,0,820,1.0,10,4.1
2025-08-18T12:07:59.312501,0,820,1.0,10,1.2
2025-08-18T12:07:59.813277,0,820,1.0,10,0.3
2025-08-18T12:08:00.313896,0,820,1.0,10,2.9
2025-08-18T12:08:00.814608,0,820,1.0,10,0.2
2025-08-18T12:08:01.315324,0,820,1.0,10,0.2
2025-08-18T12:08:01.816005,0,820,1.0,10,0.5
2025-08-18T12:08:02.316900,0,820,1.0,10,0.4
2025-08-18T12:08:02.817615,0,820,1.0,10,0.6
2025-08-18T12:08:03.318421,0,820,1.0,10,1.0
2025-08-18T12:08:03.819143,0,820,1.0,10,0.3
2025-08-18T12:08:04.319794,0,820,1.0,10,1.6
2025-08-18T12:08:04.820467,0,820,1.0,10,0.4
2025-08-18T12:08:05.321122,0,820,1.0,10,1.5
2025-08-18T12:08:05.821825,0,820,1.0,10,1.8
2025-08-18T12:08:06.322536,0,820,1.0,10,1.4
2025-08-18T12:08:06.823213,0,820,1.0,10,0.6
2025-08-18T12:08:07.323974,0,820,1.0,10,1.1
2025-08-18T12:08:07.824672,0,820,1.0,10,0.8
2025-08-18T12:08:08.325391,0,820,1.0,10,0.5
2025-08-18T12:08:08.826137,0,820,1.0,10,0.2
2025-08-18T12:08:09.326957,0,820,1.0,10,0.2
2025-08-18T12:08:09.827907,0,820,1.0,10,0.2
2025-08-18T12:08:10.328978,0,820,1.0,10,0.2
2025-08-18T12:08:10.829777,0,820,1.0,10,0.2
2025-08-18T12:08:11.330499,0,820,1.0,10,0.2
2025-08-18T12:08:11.831162,0,820,1.0,10,0.3
2025-08-18T12:08:12.331881,0,820,1.0,10,0.1
2025-08-18T12:08:12.832560,0,820,1.0,10,0.4
2025-08-18T12:08:13.333343,0,820,1.0,10,0.4
2025-08-18T12:08:13.834123,0,820,1.0,10,0.2
2025-08-18T12:08:14.334873,0,820,1.0,10,0.1
2025-08-18T12:08:14.835812,0,820,1.0,10,0.2
2025-08-18T12:08:15.336470,0,820,1.0,10,0.1
2025-08-18T12:08:15.837236,0,820,1.0,10,0.2
2025-08-18T12:08:16.338019,0,820,1.0,10,0.1
2025-08-18T12:08:16.838662,0,820,1.0,10,0.3
2025-08-18T12:08:17.339344,0,820,1.0,10,0.2
2025-08-18T12:08:17.840026,0,820,1.0,10,0.1
2025-08-18T12:08:18.340769,0,820,1.0,10,0.3
2025-08-18T12:08:18.841575,0,820,1.0,10,0.2
2025-08-18T12:08:19.342262,0,820,1.0,10,0.2
2025-08-18T12:08:19.843015,0,820,1.0,10,0.2
2025-08-18T12:08:20.343677,0,820,1.0,10,0.2
2025-08-18T12:08:20.844392,0,820,1.0,10,0.1
2025-08-18T12:08:21.345104,0,820,1.0,10,0.5
2025-08-18T12:08:21.845859,0,820,1.0,10,0.2
2025-08-18T12:08:22.346635,0,820,1.0,10,0.2
2025-08-18T12:08:22.847321,0,820,1.0,10,0.2
2025-08-18T12:08:23.348041,0,820,1.0,10,0.2
2025-08-18T12:08:23.848800,0,820,1.0,10,0.2
2025-08-18T12:08:24.349556,0,820,1.0,10,0.2
2025-08-18T12:08:24.850291,0,820,1.0,10,0.3
2025-08-18T12:08:25.351029,0,820,1.0,10,0.6
2025-08-18T12:08:25.851730,0,820,1.0,10,0.6
2025-08-18T12:08:26.352462,0,820,1.0,10,0.2
2025-08-18T12:08:26.853191,0,820,1.0,10,0.4
2025-08-18T12:08:27.353909,0,820,1.0,10,0.2
2025-08-18T12:08:27.854531,0,820,1.0,10,0.2
2025-08-18T12:08:28.355232,0,820,1.0,10,0.4
2025-08-18T12:08:28.855971,0,820,1.0,10,0.2
2025-08-18T12:08:29.356751,0,820,1.0,10,0.1
2025-08-18T12:08:29.857316,0,820,1.0,10,0.2
2025-08-18T12:08:30.358081,0,820,1.0,10,0.1
2025-08-18T12:08:30.858746,0,820,1.0,10,0.2
2025-08-18T12:08:31.359453,0,820,1.0,10,0.2
2025-08-18T12:08:31.860137,0,820,1.0,10,0.2
2025-08-18T12:08:32.360938,0,820,1.0,10,0.1
2025-08-18T12:08:32.861627,0,820,1.0,10,0.2
2025-08-18T12:08:33.362284,0,820,1.0,10,0.1
2025-08-18T12:08:33.863047,0,820,1.0,10,0.2
2025-08-18T12:08:34.363823,0,820,1.0,10,0.2
2025-08-18T12:08:34.864544,0,820,1.0,10,0.1
2025-08-18T12:08:35.365269,0,820,1.0,10,0.2
2025-08-18T12:08:35.866000,0,820,1.0,10,0.1
2025-08-18T12:08:36.366589,0,820,1.0,10,0.4
2025-08-18T12:08:36.867282,0,820,1.0,10,0.1
2025-08-18T12:08:37.367995,0,820,1.0,10,0.6
2025-08-18T12:08:37.868753,0,820,1.0,10,0.2
2025-08-18T12:08:38.369372,0,820,1.0,10,0.9
2025-08-18T12:08:38.869969,0,820,1.0,10,2.9
2025-08-18T12:08:39.370582,0,820,1.0,10,0.2
2025-08-18T12:08:39.871284,0,820,1.0,10,0.3
2025-08-18T12:08:40.371822,0,820,1.0,10,6.1
2025-08-18T12:08:40.872479,0,820,1.0,10,4.8
2025-08-18T12:08:41.373056,0,820,1.0,10,3.6
2025-08-18T12:08:41.873777,0,820,1.0,10,1.1
2025-08-18T12:08:42.374385,0,820,1.0,10,0.2
2025-08-18T12:08:42.875123,0,820,1.0,10,1.7
2025-08-18T12:08:43.376122,0,820,1.0,10,1.9
2025-08-18T12:08:43.877116,0,820,1.0,10,0.2
2025-08-18T12:08:44.377861,0,820,1.0,10,0.4
2025-08-18T12:08:44.878241,0,820,1.0,10,4.0
2025-08-18T12:08:45.378922,0,820,1.0,10,2.4
2025-08-18T12:08:45.879838,0,820,1.0,10,0.2
2025-08-18T12:08:46.380245,0,820,1.0,10,0.6
2025-08-18T12:08:46.880827,0,820,1.0,10,3.8
2025-08-18T12:08:47.381576,0,820,1.0,10,1.4
2025-08-18T12:08:47.881958,0,820,1.0,10,1.3
2025-08-18T12:08:48.382581,0,820,1.0,10,1.8
2025-08-18T12:08:48.883198,0,820,1.0,10,0.3
2025-08-18T12:08:49.383897,0,820,1.0,10,0.5
2025-08-18T12:08:49.884465,0,820,1.0,10,0.5
2025-08-18T12:08:50.385118,0,820,1.0,10,0.9
2025-08-18T12:08:50.885980,0,820,1.0,10,0.2
2025-08-18T12:08:51.386677,0,820,1.0,10,0.3
2025-08-18T12:08:51.887338,0,820,1.0,10,0.1
2025-08-18T12:08:52.388147,0,820,1.0,10,0.3
2025-08-18T12:08:52.888986,0,820,1.0,10,0.2
2025-08-18T12:08:53.389807,0,820,1.0,10,0.3
2025-08-18T12:08:53.890494,0,820,1.0,10,0.3
2025-08-18T12:08:54.391181,0,820,1.0,10,0.1
2025-08-18T12:08:54.891893,0,820,1.0,10,0.3
2025-08-18T12:08:55.392537,0,820,1.0,10,0.2
2025-08-18T12:08:55.893125,0,820,1.0,10,0.2
2025-08-18T12:08:56.393911,0,820,1.0,10,0.1
2025-08-18T12:08:56.894663,0,820,1.0,10,0.4
2025-08-18T12:08:57.395412,0,820,1.0,10,0.1
2025-08-18T12:08:57.896112,0,820,1.0,10,0.2
2025-08-18T12:08:58.396819,0,820,1.0,10,0.4
2025-08-18T12:08:58.897607,0,820,1.0,10,0.2
2025-08-18T12:08:59.398292,0,820,1.0,10,0.2
2025-08-18T12:08:59.899001,0,820,1.0,10,0.3
2025-08-18T12:09:00.399724,0,820,1.0,10,0.8
2025-08-18T12:09:00.900410,0,820,1.0,10,0.3
2025-08-18T12:09:01.401276,0,820,1.0,10,1.4
2025-08-18T12:09:01.902048,0,820,1.0,10,0.1
2025-08-18T12:09:02.402857,0,820,1.0,10,0.1
2025-08-18T12:09:02.903731,0,820,1.0,10,0.3
2025-08-18T12:09:03.404487,0,820,1.0,10,0.5
2025-08-18T12:09:03.905209,0,820,1.0,10,0.1
2025-08-18T12:09:04.405949,0,820,1.0,10,0.2
2025-08-18T12:09:04.906687,0,820,1.0,10,0.2
2025-08-18T12:09:05.407375,0,820,1.0,10,0.1
2025-08-18T12:09:05.908088,0,820,1.0,10,0.2
2025-08-18T12:09:06.408830,0,820,1.0,10,0.4
2025-08-18T12:09:06.909639,0,820,1.0,10,0.4
2025-08-18T12:09:07.410202,0,820,1.0,10,0.7
2025-08-18T12:09:07.910918,0,820,1.0,10,0.3
2025-08-18T12:09:08.411613,0,820,1.0,10,0.3
2025-08-18T12:09:08.912122,0,820,1.0,10,4.8
2025-08-18T12:09:09.412885,0,820,1.0,10,0.5
2025-08-18T12:09:09.913430,0,820,1.0,10,2.8
2025-08-18T12:09:10.414175,0,820,1.0,10,2.6
2025-08-18T12:09:10.914621,0,820,1.0,10,0.4
2025-08-18T12:09:11.415235,0,820,1.0,10,3.3
2025-08-18T12:09:11.916010,0,820,1.0,10,0.3
2025-08-18T12:09:12.416824,0,820,1.0,10,0.2
2025-08-18T12:09:12.917630,0,820,1.0,10,0.2
2025-08-18T12:09:13.418417,0,820,1.0,10,0.5
2025-08-18T12:09:13.919175,0,820,1.0,10,1.0
2025-08-18T12:09:14.419952,0,820,1.0,10,0.2
2025-08-18T12:09:14.920704,0,820,1.0,10,0.3
2025-08-18T12:09:15.421493,0,820,1.0,10,0.2
2025-08-18T12:09:15.922320,0,820,1.0,10,0.1
2025-08-18T12:09:16.423072,0,820,1.0,10,0.1
2025-08-18T12:09:16.923843,0,820,1.0,10,0.1
2025-08-18T12:09:17.424631,0,820,1.0,10,0.1
2025-08-18T12:09:17.925346,0,820,1.0,10,0.3
2025-08-18T12:09:18.426036,0,820,1.0,10,0.2
2025-08-18T12:09:18.926832,0,820,1.0,10,0.2
2025-08-18T12:09:19.427644,0,820,1.0,10,0.2
2025-08-18T12:09:19.928336,0,820,1.0,10,0.3
2025-08-18T12:09:20.429143,0,820,1.0,10,0.3
2025-08-18T12:09:20.929912,0,820,1.0,10,0.2
2025-08-18T12:09:21.430630,0,820,1.0,10,0.1
2025-08-18T12:09:21.931355,0,820,1.0,10,0.2
2025-08-18T12:09:22.432032,0,820,1.0,10,0.1
2025-08-18T12:09:22.932786,0,820,1.0,10,0.2
2025-08-18T12:09:23.433478,0,820,1.0,10,0.2
2025-08-18T12:09:23.934167,0,820,1.0,10,0.2
2025-08-18T12:09:24.434892,0,820,1.0,10,0.2
2025-08-18T12:09:24.935564,0,820,1.0,10,0.3
2025-08-18T12:09:25.436182,0,820,1.0,10,0.1
2025-08-18T12:09:25.936933,0,820,1.0,10,0.3
2025-08-18T12:09:26.437644,0,820,1.0,10,0.1
2025-08-18T12:09:26.938311,0,820,1.0,10,0.2
2025-08-18T12:09:27.439096,0,820,1.0,10,0.1
2025-08-18T12:09:27.939815,0,820,1.0,10,0.3
2025-08-18T12:09:28.440441,0,820,1.0,10,0.2
2025-08-18T12:09:28.941176,0,820,1.0,10,0.2
2025-08-18T12:09:29.441871,0,820,1.0,10,0.2
2025-08-18T12:09:29.942680,0,820,1.0,10,0.2
2025-08-18T12:09:30.443456,0,820,1.0,10,0.1
2025-08-18T12:09:30.944189,0,820,1.0,10,0.1
2025-08-18T12:09:31.444843,0,820,1.0,10,0.2
2025-08-18T12:09:31.945590,0,820,1.0,10,0.1
2025-08-18T12:09:32.446267,0,820,1.0,10,0.2
2025-08-18T12:09:32.946894,0,820,1.0,10,0.2
2025-08-18T12:09:33.447616,0,820,1.0,10,0.2
2025-08-18T12:09:33.948357,0,820,1.0,10,0.2
2025-08-18T12:09:34.449101,0,820,1.0,10,0.2
2025-08-18T12:09:34.949854,0,820,1.0,10,0.3
2025-08-18T12:09:35.450635,0,820,1.0,10,0.2
2025-08-18T12:09:35.951414,0,820,1.0,10,0.2
2025-08-18T12:09:36.451963,0,820,1.0,10,0.4
2025-08-18T12:09:36.952751,0,820,1.0,10,0.1
2025-08-18T12:09:37.453356,0,820,1.0,10,0.4
2025-08-18T12:09:37.953949,0,820,1.0,10,1.1
2025-08-18T12:09:38.454628,0,820,1.0,10,0.9
2025-08-18T12:09:38.955357,0,820,1.0,10,0.5
2025-08-18T12:09:39.456099,0,820,1.0,10,0.7
2025-08-18T12:09:39.956907,0,820,1.0,10,0.3
2025-08-18T12:09:40.457711,0,820,1.0,10,0.2
2025-08-18T12:09:40.958552,0,820,1.0,10,0.1
2025-08-18T12:09:41.459333,0,820,1.0,10,0.4
2025-08-18T12:09:41.960100,0,820,1.0,10,0.2
2025-08-18T12:09:42.460805,0,820,1.0,10,0.1
2025-08-18T12:09:42.961598,0,820,1.0,10,0.2
2025-08-18T12:09:43.462326,0,820,1.0,10,0.3
2025-08-18T12:09:43.963082,0,820,1.0,10,0.1
2025-08-18T12:09:44.463808,0,820,1.0,10,0.3
2025-08-18T12:09:44.964565,0,820,1.0,10,0.1
2025-08-18T12:09:45.465256,0,820,1.0,10,0.3
2025-08-18T12:09:45.966015,0,820,1.0,10,0.1
2025-08-18T12:09:46.466768,0,820,1.0,10,0.1
2025-08-18T12:09:46.967396,0,820,1.0,10,3.6
2025-08-18T12:09:47.467910,0,820,1.0,10,2.8
2025-08-18T12:09:47.968322,0,820,1.0,10,4.5
2025-08-18T12:09:48.468963,0,820,1.0,10,1.8
2025-08-18T12:09:48.969503,0,820,1.0,10,0.9
2025-08-18T12:09:49.470039,0,820,1.0,10,2.6
2025-08-18T12:09:49.970761,0,820,1.0,10,1.6
2025-08-18T12:09:50.471436,0,820,1.0,10,0.6
2025-08-18T12:09:50.972042,0,820,1.0,10,2.4
2025-08-18T12:09:51.472771,0,820,1.0,10,0.6
2025-08-18T12:09:51.973347,0,820,1.0,10,2.3
2025-08-18T12:09:52.474023,0,820,1.0,10,1.3
2025-08-18T12:09:52.974589,0,820,1.0,10,2.1
2025-08-18T12:09:53.475174,0,820,1.0,10,0.7
2025-08-18T12:09:53.975879,0,820,1.0,10,0.3
2025-08-18T12:09:54.476711,0,820,1.0,10,0.1
2025-08-18T12:09:54.977184,0,820,1.0,10,1.9
2025-08-18T12:09:55.477912,0,820,1.0,10,0.1
2025-08-18T12:09:55.978674,0,820,1.0,10,0.1
2025-08-18T12:09:56.479477,0,820,1.0,10,0.2
2025-08-18T12:09:56.980229,0,820,1.0,10,0.3
2025-08-18T12:09:57.480995,0,820,1.0,10,0.1
2025-08-18T12:09:57.981799,0,820,1.0,10,0.3
2025-08-18T12:09:58.482630,0,820,1.0,10,0.3
2025-08-18T12:09:58.983434,0,820,1.0,10,0.1
2025-08-18T12:09:59.484327,0,820,1.0,10,0.2
2025-08-18T12:09:59.985135,0,820,1.0,10,0.2
2025-08-18T12:10:00.485878,0,820,1.0,10,0.9
2025-08-18T12:10:00.986618,0,820,1.0,10,0.2
2025-08-18T12:10:01.487321,0,820,1.0,10,0.1
2025-08-18T12:10:01.987998,0,820,1.0,10,0.1
2025-08-18T12:10:02.488762,0,820,1.0,10,0.3
2025-08-18T12:10:02.989610,0,820,1.0,10,0.2
2025-08-18T12:10:03.490431,0,820,1.0,10,0.7
2025-08-18T12:10:03.991283,0,820,1.0,10,0.3
2025-08-18T12:10:04.492172,0,820,1.0,10,0.4
2025-08-18T12:10:04.993052,0,820,1.0,10,0.3
2025-08-18T12:10:05.493949,0,820,1.0,10,0.2
2025-08-18T12:10:05.994731,0,820,1.0,10,0.2
2025-08-18T12:10:06.495559,0,820,1.0,10,0.1
2025-08-18T12:10:06.996309,0,820,1.0,10,0.6
2025-08-18T12:10:07.497014,0,820,1.0,10,0.2
2025-08-18T12:10:07.997744,0,820,1.0,10,0.6
2025-08-18T12:10:08.498550,0,820,1.0,10,0.3
2025-08-18T12:10:08.999298,0,820,1.0,10,0.4
2025-08-18T12:10:09.500027,0,820,1.0,10,0.3
2025-08-18T12:10:10.000806,0,820,1.0,10,0.1
2025-08-18T12:10:10.501557,0,820,1.0,10,0.2
2025-08-18T12:10:11.002343,0,820,1.0,10,0.2
2025-08-18T12:10:11.503091,0,820,1.0,10,0.1
2025-08-18T12:10:12.003908,0,820,1.0,10,0.2
2025-08-18T12:10:12.504692,0,820,1.0,10,0.2
2025-08-18T12:10:13.005461,0,820,1.0,10,0.1
2025-08-18T12:10:13.506223,0,820,1.0,10,0.4
2025-08-18T12:10:14.007015,0,820,1.0,10,0.1
2025-08-18T12:10:14.507759,0,820,1.0,10,0.4
2025-08-18T12:10:15.008355,0,820,1.0,10,6.1
2025-08-18T12:10:15.508668,0,820,1.0,10,6.1
2025-08-18T12:10:16.009275,0,820,1.0,10,1.1
2025-08-18T12:10:16.509998,0,820,1.0,10,0.3
2025-08-18T12:10:17.010329,0,820,1.0,10,3.5
2025-08-18T12:10:17.511004,0,820,1.0,10,1.8
2025-08-18T12:10:18.011703,0,820,1.0,10,1.8
2025-08-18T12:10:18.512120,0,820,1.0,10,1.5
2025-08-18T12:10:19.012502,0,820,1.0,10,1.6
2025-08-18T12:10:19.512881,0,820,1.0,10,2.1
2025-08-18T12:10:20.013150,0,820,1.0,10,2.8
2025-08-18T12:10:20.513621,0,820,1.0,10,2.4
2025-08-18T12:10:21.014366,0,820,1.0,10,1.3
2025-08-18T12:10:21.514692,0,820,1.0,10,2.3
2025-08-18T12:10:22.015199,0,820,1.0,10,5.0
2025-08-18T12:10:22.515928,0,820,1.0,10,1.7
2025-08-18T12:10:23.016657,0,820,1.0,10,0.8
2025-08-18T12:10:23.517261,0,820,1.0,10,0.5
2025-08-18T12:10:24.018030,0,820,1.0,10,0.4
2025-08-18T12:10:24.518775,0,820,1.0,10,0.2
2025-08-18T12:10:25.019336,0,820,1.0,10,2.3
2025-08-18T12:10:25.520018,0,820,1.0,10,3.0
2025-08-18T12:10:26.020620,0,820,1.0,10,2.1
2025-08-18T12:10:26.521202,0,820,1.0,10,2.5
2025-08-18T12:10:27.021821,0,820,1.0,10,1.5
2025-08-18T12:10:27.522167,0,820,1.0,10,2.3
2025-08-18T12:10:28.022762,0,820,1.0,10,2.5
2025-08-18T12:10:28.523407,0,820,1.0,10,1.9
2025-08-18T12:10:29.023726,0,820,1.0,10,1.8
2025-08-18T12:10:29.524298,0,820,1.0,10,1.3
2025-08-18T12:10:30.024607,0,820,1.0,10,1.7
2025-08-18T12:10:30.525119,0,820,1.0,10,1.5
2025-08-18T12:10:31.025582,0,820,1.0,10,5.4
2025-08-18T12:10:31.526015,0,820,1.0,10,4.5
2025-08-18T12:10:32.026444,0,820,1.0,10,4.4
2025-08-18T12:10:32.527358,0,820,1.0,10,4.3
2025-08-18T12:10:33.028356,0,820,1.0,10,2.5
2025-08-18T12:10:33.528910,0,820,1.0,10,3.4
2025-08-18T12:10:34.029678,0,820,1.0,10,3.0
2025-08-18T12:10:34.530560,0,820,1.0,10,0.3
2025-08-18T12:10:35.031160,0,820,1.0,10,0.9
2025-08-18T12:10:35.531794,0,820,1.0,10,3.8
2025-08-18T12:10:36.032726,0,820,1.0,10,2.5
2025-08-18T12:10:36.533179,0,820,1.0,10,2.1
2025-08-18T12:10:37.033473,0,820,1.0,10,2.8
2025-08-18T12:10:37.534006,0,820,1.0,10,3.0
2025-08-18T12:10:38.034560,0,820,1.0,10,2.3
2025-08-18T12:10:38.535243,0,820,1.0,10,2.6
2025-08-18T12:10:39.035855,0,820,1.0,10,4.2
2025-08-18T12:10:39.536579,0,820,1.0,10,1.8
2025-08-18T12:10:40.037147,0,820,1.0,10,1.8
2025-08-18T12:10:40.537462,0,820,1.0,10,1.8
2025-08-18T12:10:41.037664,0,820,1.0,10,3.3
2025-08-18T12:10:41.537920,0,820,1.0,10,5.0
2025-08-18T12:10:42.038479,0,820,1.0,10,1.6
2025-08-18T12:10:42.539199,0,820,1.0,10,3.0
2025-08-18T12:10:43.039992,0,820,1.0,10,0.5
2025-08-18T12:10:43.540581,0,820,1.0,10,1.1
2025-08-18T12:10:44.041310,0,820,1.0,10,3.1
2025-08-18T12:10:44.542061,0,820,1.0,10,0.2
2025-08-18T12:10:45.042948,0,820,1.0,10,0.1
2025-08-18T12:10:45.543832,0,820,1.0,10,0.1
2025-08-18T12:10:46.044542,0,820,1.0,10,0.9
2025-08-18T12:10:46.545008,0,820,1.0,10,2.2
2025-08-18T12:10:47.045333,0,820,1.0,10,2.9
2025-08-18T12:10:47.546056,0,820,1.0,10,0.4
2025-08-18T12:10:48.046387,0,820,1.0,10,1.8
2025-08-18T12:10:48.547091,0,820,1.0,10,3.6
2025-08-18T12:10:49.047743,0,820,1.0,10,0.4
2025-08-18T12:10:49.548226,0,820,1.0,10,2.0
2025-08-18T12:10:50.048811,0,820,1.0,10,2.1
2025-08-18T12:10:50.549389,0,820,1.0,10,0.2
2025-08-18T12:10:51.050145,0,820,1.0,10,0.1
2025-08-18T12:10:51.550905,0,820,1.0,10,0.2
2025-08-18T12:10:52.051590,0,820,1.0,10,1.2
2025-08-18T12:10:52.552310,0,820,1.0,10,0.2
2025-08-18T12:10:53.052972,0,820,1.0,10,0.3
2025-08-18T12:10:53.553636,0,820,1.0,10,0.7
2025-08-18T12:10:54.054397,0,820,1.0,10,0.5
2025-08-18T12:10:54.555181,0,820,1.0,10,0.2
2025-08-18T12:10:55.055950,0,820,1.0,10,0.3
2025-08-18T12:10:55.556792,0,820,1.0,10,0.1
2025-08-18T12:10:56.057556,0,820,1.0,10,0.2
2025-08-18T12:10:56.558296,0,820,1.0,10,0.1
2025-08-18T12:10:57.059087,0,820,1.0,10,0.1
2025-08-18T12:10:57.559841,0,820,1.0,10,0.2
2025-08-18T12:10:58.060505,0,820,1.0,10,0.5
2025-08-18T12:10:58.561307,0,820,1.0,10,0.6
2025-08-18T12:10:59.062083,0,820,1.0,10,0.9
2025-08-18T12:10:59.562859,0,820,1.0,10,0.2
2025-08-18T12:11:00.063635,0,820,1.0,10,0.3
2025-08-18T12:11:00.564304,0,820,1.0,10,0.6
2025-08-18T12:11:01.065346,0,820,1.0,10,0.2
2025-08-18T12:11:01.566044,0,820,1.0,10,0.1
2025-08-18T12:11:02.066746,0,820,1.0,10,0.1
2025-08-18T12:11:02.567406,0,820,1.0,10,0.1
2025-08-18T12:11:03.068134,0,820,1.0,10,0.2
2025-08-18T12:11:03.568951,0,820,1.0,10,0.5
2025-08-18T12:11:04.069653,0,820,1.0,10,0.2
2025-08-18T12:11:04.570264,0,820,1.0,10,0.2
2025-08-18T12:11:05.071039,0,820,1.0,10,0.2
2025-08-18T12:11:05.571989,0,820,1.0,10,0.1
2025-08-18T12:11:06.072762,0,820,1.0,10,0.1
2025-08-18T12:11:06.573379,0,820,1.0,10,0.2
2025-08-18T12:11:07.074164,0,820,1.0,10,0.6
2025-08-18T12:11:07.574924,0,820,1.0,10,0.2
2025-08-18T12:11:08.075635,0,820,1.0,10,0.6
2025-08-18T12:11:08.576251,0,820,1.0,10,0.3
2025-08-18T12:11:09.077000,0,820,1.0,10,0.3
2025-08-18T12:11:09.577806,0,820,1.0,10,0.1
2025-08-18T12:11:10.078609,0,820,1.0,10,0.2
2025-08-18T12:11:10.579318,0,820,1.0,10,0.2
2025-08-18T12:11:11.080046,0,820,1.0,10,0.1
2025-08-18T12:11:11.580841,0,820,1.0,10,0.2
2025-08-18T12:11:12.081709,0,820,1.0,10,0.1
2025-08-18T12:11:12.582549,0,820,1.0,10,0.2
2025-08-18T12:11:13.083297,0,820,1.0,10,0.1
2025-08-18T12:11:13.584021,0,820,1.0,10,0.1
2025-08-18T12:11:14.084742,0,820,1.0,10,0.2
2025-08-18T12:11:14.585541,0,820,1.0,10,0.1
2025-08-18T12:11:15.086326,0,820,1.0,10,0.3
2025-08-18T12:11:15.586993,0,820,1.0,10,0.2
2025-08-18T12:11:16.087847,0,820,1.0,10,0.1
2025-08-18T12:11:16.588654,0,820,1.0,10,0.1
2025-08-18T12:11:17.089403,0,820,1.0,10,0.1
2025-08-18T12:11:17.590187,0,820,1.0,10,0.2
2025-08-18T12:11:18.091063,0,820,1.0,10,0.1
2025-08-18T12:11:18.591949,0,820,1.0,10,0.3
2025-08-18T12:11:19.092766,0,820,1.0,10,0.2
2025-08-18T12:11:19.593539,0,820,1.0,10,0.1
2025-08-18T12:11:20.094345,0,820,1.0,10,0.2
2025-08-18T12:11:20.595113,0,820,1.0,10,0.2
2025-08-18T12:11:21.095885,0,820,1.0,10,0.2
2025-08-18T12:11:21.596628,0,820,1.0,10,0.1
2025-08-18T12:11:22.097397,0,820,1.0,10,0.1
2025-08-18T12:11:22.598108,0,820,1.0,10,0.1
2025-08-18T12:11:23.098881,0,820,1.0,10,0.2
2025-08-18T12:11:23.599650,0,820,1.0,10,0.2
2025-08-18T12:11:24.100418,0,820,1.0,10,0.1
2025-08-18T12:11:24.601204,0,820,1.0,10,0.3
2025-08-18T12:11:25.102015,0,820,1.0,10,0.2
2025-08-18T12:11:25.602805,0,820,1.0,10,0.2
2025-08-18T12:11:26.103663,0,820,1.0,10,0.1
2025-08-18T12:11:26.604376,0,820,1.0,10,0.1
2025-08-18T12:11:27.105131,0,820,1.0,10,0.2
2025-08-18T12:11:27.605907,0,820,1.0,10,0.1
2025-08-18T12:11:28.106740,0,820,1.0,10,0.1
2025-08-18T12:11:28.607641,0,820,1.0,10,0.4
2025-08-18T12:11:29.108458,0,820,1.0,10,0.2
2025-08-18T12:11:29.609333,0,820,1.0,10,0.3
2025-08-18T12:11:30.110175,0,820,1.0,10,0.2
2025-08-18T12:11:30.611005,0,820,1.0,10,0.1
2025-08-18T12:11:31.111860,0,820,1.0,10,0.1
2025-08-18T12:11:31.612580,0,820,1.0,10,0.2
2025-08-18T12:11:32.113475,0,820,1.0,10,0.2
2025-08-18T12:11:32.614276,0,820,1.0,10,0.2
2025-08-18T12:11:33.115029,0,820,1.0,10,0.2
2025-08-18T12:11:33.615813,0,820,1.0,10,0.2
2025-08-18T12:11:34.116619,0,820,1.0,10,0.1
2025-08-18T12:11:34.617432,0,820,1.0,10,0.2
2025-08-18T12:11:35.118320,0,820,1.0,10,0.2
2025-08-18T12:11:35.619064,0,820,1.0,10,0.1
2025-08-18T12:11:36.119911,0,820,1.0,10,0.2
2025-08-18T12:11:36.620698,0,820,1.0,10,0.2
2025-08-18T12:11:37.121376,0,820,1.0,10,0.5
2025-08-18T12:11:37.622233,0,820,1.0,10,0.1
2025-08-18T12:11:38.122968,0,820,1.0,10,0.6
2025-08-18T12:11:38.623767,0,820,1.0,10,2.3
2025-08-18T12:11:39.124395,0,820,1.0,10,0.3
2025-08-18T12:11:39.625104,0,820,1.0,10,0.8
2025-08-18T12:11:40.125815,0,820,1.0,10,0.3
2025-08-18T12:11:40.626544,0,820,1.0,10,0.1
2025-08-18T12:11:41.127274,0,820,1.0,10,0.2
2025-08-18T12:11:41.628002,0,820,1.0,10,0.2
2025-08-18T12:11:42.128774,0,820,1.0,10,0.1
2025-08-18T12:11:42.629565,0,820,1.0,10,0.1
2025-08-18T12:11:43.130289,0,820,1.0,10,0.1
2025-08-18T12:11:43.630977,0,820,1.0,10,0.4
2025-08-18T12:11:44.131699,0,820,1.0,10,0.1
2025-08-18T12:11:44.632390,0,820,1.0,10,0.2
2025-08-18T12:11:45.133122,0,820,1.0,10,0.2
2025-08-18T12:11:45.633838,0,820,1.0,10,0.1
2025-08-18T12:11:46.134623,0,820,1.0,10,0.1
2025-08-18T12:11:46.635333,0,820,1.0,10,0.2
2025-08-18T12:11:47.136191,0,820,1.0,10,0.1
2025-08-18T12:11:47.636950,0,820,1.0,10,0.2
2025-08-18T12:11:48.137672,0,820,1.0,10,0.1
2025-08-18T12:11:48.638416,0,820,1.0,10,0.2
2025-08-18T12:11:49.138763,0,820,1.0,10,0.5
2025-08-18T12:11:49.639291,0,820,1.0,10,0.3
2025-08-18T12:11:50.139891,0,820,1.0,10,0.2
2025-08-18T12:11:50.640645,0,820,1.0,10,0.1
2025-08-18T12:11:51.141323,0,820,1.0,10,0.2
2025-08-18T12:11:51.642054,0,820,1.0,10,0.1
2025-08-18T12:11:52.142832,0,820,1.0,10,0.3
2025-08-18T12:11:52.643613,0,820,1.0,10,0.1
2025-08-18T12:11:53.144255,0,820,1.0,10,0.2
2025-08-18T12:11:53.644962,0,820,1.0,10,0.3
2025-08-18T12:11:54.145746,0,820,1.0,10,0.1
2025-08-18T12:11:54.646578,0,820,1.0,10,0.2
2025-08-18T12:11:55.147257,0,820,1.0,10,0.1
2025-08-18T12:11:55.647966,0,820,1.0,10,0.1
2025-08-18T12:11:56.148704,0,820,1.0,10,0.1
2025-08-18T12:11:56.649413,0,820,1.0,10,0.2
2025-08-18T12:11:57.150129,0,820,1.0,10,0.2
2025-08-18T12:11:57.650843,0,820,1.0,10,0.1
2025-08-18T12:11:58.151571,0,820,1.0,10,0.1
2025-08-18T12:11:58.652198,0,820,1.0,10,0.2
2025-08-18T12:11:59.152956,0,820,1.0,10,0.1
2025-08-18T12:11:59.653711,0,820,1.0,10,0.1
2025-08-18T12:12:00.154433,0,820,1.0,10,0.3
2025-08-18T12:12:00.655065,0,820,1.0,10,0.8
2025-08-18T12:12:01.155667,0,820,1.0,10,0.2
2025-08-18T12:12:01.656426,0,820,1.0,10,0.2
2025-08-18T12:12:02.157201,0,820,1.0,10,0.1
2025-08-18T12:12:02.657920,0,820,1.0,10,0.2
2025-08-18T12:12:03.158659,0,820,1.0,10,0.3
2025-08-18T12:12:03.659397,0,820,1.0,10,0.6
2025-08-18T12:12:04.160065,0,820,1.0,10,0.1
2025-08-18T12:12:04.660796,0,820,1.0,10,0.3
2025-08-18T12:12:05.161560,0,820,1.0,10,0.1
2025-08-18T12:12:05.662287,0,820,1.0,10,0.2
2025-08-18T12:12:06.163002,0,820,1.0,10,0.2
2025-08-18T12:12:06.663604,0,820,1.0,10,0.1
2025-08-18T12:12:07.164144,0,820,1.0,10,0.4
2025-08-18T12:12:07.664852,0,820,1.0,10,0.1
2025-08-18T12:12:08.165495,0,820,1.0,10,0.4
2025-08-18T12:12:08.666208,0,820,1.0,10,0.6
2025-08-18T12:12:09.167010,0,820,1.0,10,0.1
2025-08-18T12:12:09.667799,0,820,1.0,10,0.3
2025-08-18T12:12:10.168596,0,820,1.0,10,0.2
2025-08-18T12:12:10.669354,0,820,1.0,10,0.2
2025-08-18T12:12:11.170070,0,820,1.0,10,0.1
2025-08-18T12:12:11.670893,0,820,1.0,10,0.1
2025-08-18T12:12:12.171689,0,820,1.0,10,0.1
2025-08-18T12:12:12.672506,0,820,1.0,10,0.2
2025-08-18T12:12:13.173337,0,820,1.0,10,0.2
2025-08-18T12:12:13.674120,0,820,1.0,10,0.4
2025-08-18T12:12:14.174896,0,820,1.0,10,0.2
2025-08-18T12:12:14.675714,0,820,1.0,10,0.2
2025-08-18T12:12:15.176479,0,820,1.0,10,0.2
2025-08-18T12:12:15.677278,0,820,1.0,10,0.1
2025-08-18T12:12:16.178040,0,820,1.0,10,0.2
2025-08-18T12:12:16.678854,0,820,1.0,10,0.2
2025-08-18T12:12:17.179741,0,820,1.0,10,0.1
2025-08-18T12:12:17.680486,0,820,1.0,10,0.2
2025-08-18T12:12:18.181072,0,820,1.0,10,2.6
2025-08-18T12:12:18.681788,0,820,1.0,10,2.6
2025-08-18T12:12:19.182491,0,820,1.0,10,0.1
2025-08-18T12:12:19.683222,0,820,1.0,10,0.2
2025-08-18T12:12:20.183985,0,820,1.0,10,0.3
2025-08-18T12:12:20.684715,0,820,1.0,10,0.1
2025-08-18T12:12:21.185369,0,820,1.0,10,0.1
2025-08-18T12:12:21.686094,0,820,1.0,10,0.1
2025-08-18T12:12:22.186751,0,820,1.0,10,0.2
2025-08-18T12:12:22.687454,0,820,1.0,10,0.2
2025-08-18T12:12:23.188178,0,820,1.0,10,0.1
2025-08-18T12:12:23.688860,0,820,1.0,10,0.3
2025-08-18T12:12:24.189604,0,820,1.0,10,0.1
2025-08-18T12:12:24.690291,0,820,1.0,10,0.3
2025-08-18T12:12:25.190993,0,820,1.0,10,0.1
2025-08-18T12:12:25.691824,0,820,1.0,10,0.1
2025-08-18T12:12:26.192571,0,820,1.0,10,0.1
2025-08-18T12:12:26.693205,0,820,1.0,10,0.2
2025-08-18T12:12:27.193935,0,820,1.0,10,0.1
2025-08-18T12:12:27.694650,0,820,1.0,10,0.2
2025-08-18T12:12:28.195334,0,820,1.0,10,0.1
2025-08-18T12:12:28.695971,0,820,1.0,10,0.3
2025-08-18T12:12:29.196759,0,820,1.0,10,0.1
2025-08-18T12:12:29.697480,0,820,1.0,10,0.2
2025-08-18T12:12:30.198319,0,820,1.0,10,0.1
2025-08-18T12:12:30.699084,0,820,1.0,10,0.1
2025-08-18T12:12:31.200004,0,820,1.0,10,0.1
2025-08-18T12:12:31.700942,0,820,1.0,10,0.1
2025-08-18T12:12:32.201732,0,820,1.0,10,0.1
2025-08-18T12:12:32.702452,0,820,1.0,10,0.2
2025-08-18T12:12:33.203205,0,820,1.0,10,0.1
2025-08-18T12:12:33.703968,0,820,1.0,10,0.2
2025-08-18T12:12:34.204721,0,820,1.0,10,0.1
2025-08-18T12:12:34.705475,0,820,1.0,10,0.2
2025-08-18T12:12:35.206290,0,820,1.0,10,0.1
2025-08-18T12:12:35.707070,0,820,1.0,10,0.1
2025-08-18T12:12:36.207843,0,820,1.0,10,0.1
2025-08-18T12:12:36.708567,0,820,1.0,10,0.1
2025-08-18T12:12:37.209307,0,820,1.0,10,0.2
2025-08-18T12:12:37.710405,0,820,1.0,10,0.4
2025-08-18T12:12:38.211067,0,820,1.0,10,0.1
2025-08-18T12:12:38.711788,0,820,1.0,10,0.9
2025-08-18T12:12:39.212430,0,820,1.0,10,0.1
2025-08-18T12:12:39.713122,0,820,1.0,10,0.9
2025-08-18T12:12:40.213886,0,820,1.0,10,0.3
2025-08-18T12:12:40.714549,0,820,1.0,10,0.1
2025-08-18T12:12:41.215140,0,820,1.0,10,0.1
2025-08-18T12:12:41.715835,0,820,1.0,10,0.2
2025-08-18T12:12:42.216457,0,820,1.0,10,0.2
2025-08-18T12:12:42.717212,0,820,1.0,10,0.1
2025-08-18T12:12:43.218017,0,820,1.0,10,0.1
2025-08-18T12:12:43.718824,0,820,1.0,10,0.2
2025-08-18T12:12:44.219609,0,820,1.0,10,0.2
2025-08-18T12:12:44.720303,0,820,1.0,10,0.1
2025-08-18T12:12:45.221032,0,820,1.0,10,0.1
2025-08-18T12:12:45.721763,0,820,1.0,10,0.1
2025-08-18T12:12:46.222430,0,820,1.0,10,0.1
2025-08-18T12:12:46.723151,0,820,1.0,10,0.4
2025-08-18T12:12:47.223865,0,820,1.0,10,0.1
2025-08-18T12:12:47.724534,0,820,1.0,10,0.1
2025-08-18T12:12:48.225495,0,820,1.0,10,0.2
2025-08-18T12:12:48.726502,0,820,1.0,10,0.3
2025-08-18T12:12:49.227564,0,820,1.0,10,0.4
2025-08-18T12:12:49.728556,0,820,1.0,10,1.6
2025-08-18T12:12:50.229413,0,820,1.0,10,0.2
2025-08-18T12:12:50.730092,0,820,1.0,10,0.2
2025-08-18T12:12:51.231099,0,820,1.0,10,0.1
2025-08-18T12:12:51.731808,0,820,1.0,10,0.1
2025-08-18T12:12:52.232393,0,820,1.0,10,0.1
2025-08-18T12:12:52.732995,0,820,1.0,10,0.1
2025-08-18T12:12:53.233877,0,820,1.0,10,0.1
2025-08-18T12:12:53.734671,0,820,1.0,10,0.3
2025-08-18T12:12:54.235443,0,820,1.0,10,0.2
2025-08-18T12:12:54.736189,0,820,1.0,10,0.2
2025-08-18T12:12:55.236961,0,820,1.0,10,0.1
2025-08-18T12:12:55.737761,0,820,1.0,10,0.2
2025-08-18T12:12:56.238555,0,820,1.0,10,0.1
2025-08-18T12:12:56.739296,0,820,1.0,10,0.1
2025-08-18T12:12:57.240123,0,820,1.0,10,0.2
2025-08-18T12:12:57.740872,0,820,1.0,10,0.1
2025-08-18T12:12:58.241577,0,820,1.0,10,0.1
2025-08-18T12:12:58.742311,0,820,1.0,10,0.2
2025-08-18T12:12:59.243065,0,820,1.0,10,0.2
2025-08-18T12:12:59.743857,0,820,1.0,10,0.1
2025-08-18T12:13:00.244611,0,820,1.0,10,0.3
2025-08-18T12:13:00.745415,0,820,1.0,10,0.8
2025-08-18T12:13:01.246262,0,820,1.0,10,0.1
2025-08-18T12:13:01.747065,0,820,1.0,10,0.1
2025-08-18T12:13:02.247791,0,820,1.0,10,0.2
2025-08-18T12:13:02.748578,0,820,1.0,10,0.1
2025-08-18T12:13:03.249286,0,820,1.0,10,0.5
2025-08-18T12:13:03.750011,0,820,1.0,10,0.2
2025-08-18T12:13:04.250839,0,820,1.0,10,0.2
2025-08-18T12:13:04.751663,0,820,1.0,10,0.2
2025-08-18T12:13:05.252491,0,820,1.0,10,0.1
2025-08-18T12:13:05.753294,0,820,1.0,10,0.2
2025-08-18T12:13:06.254044,0,820,1.0,10,0.1
2025-08-18T12:13:06.754780,0,820,1.0,10,0.0
2025-08-18T12:13:07.255559,0,820,1.0,10,0.1
2025-08-18T12:13:07.756329,0,820,1.0,10,0.6
2025-08-18T12:13:08.257129,0,820,1.0,10,0.1
2025-08-18T12:13:08.757835,0,820,1.0,10,0.9
2025-08-18T12:13:09.258505,0,820,1.0,10,0.1
2025-08-18T12:13:09.759165,0,820,1.0,10,0.3
2025-08-18T12:13:10.259943,0,820,1.0,10,0.2
2025-08-18T12:13:10.760618,0,820,1.0,10,0.2
2025-08-18T12:13:11.261487,0,820,1.0,10,5.2
2025-08-18T12:13:11.762550,0,820,1.0,10,0.6
2025-08-18T12:13:12.263312,0,820,1.0,10,1.2
2025-08-18T12:13:12.764069,0,820,1.0,10,0.2
2025-08-18T12:13:13.264722,0,820,1.0,10,0.9
2025-08-18T12:13:13.765469,0,820,1.0,10,0.3
2025-08-18T12:13:14.266183,0,820,1.0,10,0.3
2025-08-18T12:13:14.766992,0,820,1.0,10,1.2
2025-08-18T12:13:15.267379,0,820,1.0,10,2.4
2025-08-18T12:13:15.767900,0,820,1.0,10,3.1
2025-08-18T12:13:16.268315,0,820,1.0,10,3.2
2025-08-18T12:13:16.768699,0,820,1.0,10,3.8
2025-08-18T12:13:17.269205,0,820,1.0,10,2.4
2025-08-18T12:13:17.769893,0,820,1.0,10,1.3
2025-08-18T12:13:18.270689,0,820,1.0,10,0.2
2025-08-18T12:13:18.771393,0,820,1.0,10,0.4
2025-08-18T12:13:19.272063,0,820,1.0,10,0.2
2025-08-18T12:13:19.772837,0,820,1.0,10,0.1
2025-08-18T12:13:20.273572,0,820,1.0,10,0.2
2025-08-18T12:13:20.774303,0,820,1.0,10,0.2
2025-08-18T12:13:21.275084,0,820,1.0,10,1.0
2025-08-18T12:13:21.775938,0,820,1.0,10,0.1
2025-08-18T12:13:22.276659,0,820,1.0,10,0.1
2025-08-18T12:13:22.777694,0,820,1.0,10,0.2
2025-08-18T12:13:23.278584,0,820,1.0,10,0.1
2025-08-18T12:13:23.779581,0,820,1.0,10,0.5
2025-08-18T12:13:24.280372,0,820,1.0,10,0.1
2025-08-18T12:13:24.781256,0,820,1.0,10,0.1
2025-08-18T12:13:25.282062,0,820,1.0,10,0.3
2025-08-18T12:13:25.783011,0,820,1.0,10,0.2
2025-08-18T12:13:26.283871,0,820,1.0,10,0.1
2025-08-18T12:13:26.784753,0,820,1.0,10,0.2
2025-08-18T12:13:27.285547,0,820,1.0,10,0.3
2025-08-18T12:13:27.786316,0,820,1.0,10,0.2
2025-08-18T12:13:28.287107,0,820,1.0,10,0.2
2025-08-18T12:13:28.787969,0,820,1.0,10,0.3
2025-08-18T12:13:29.288814,0,820,1.0,10,0.1
2025-08-18T12:13:29.789678,0,820,1.0,10,0.1
2025-08-18T12:13:30.290477,0,820,1.0,10,0.1
2025-08-18T12:13:30.791365,0,820,1.0,10,0.2
2025-08-18T12:13:31.292124,0,820,1.0,10,0.2
2025-08-18T12:13:31.792987,0,820,1.0,10,0.1
2025-08-18T12:13:32.293982,0,820,1.0,10,0.1
2025-08-18T12:13:32.794906,0,820,1.0,10,0.2
2025-08-18T12:13:33.295739,0,820,1.0,10,0.1
2025-08-18T12:13:33.796593,0,820,1.0,10,0.3
2025-08-18T12:13:34.297196,0,820,1.0,10,0.1
2025-08-18T12:13:34.797827,0,820,1.0,10,0.1
2025-08-18T12:13:35.298601,0,820,1.0,10,0.2
2025-08-18T12:13:35.799304,0,820,1.0,10,0.1
2025-08-18T12:13:36.300031,0,820,1.0,10,0.2
2025-08-18T12:13:36.800767,0,820,1.0,10,0.1
2025-08-18T12:13:37.301498,0,820,1.0,10,0.2
2025-08-18T12:13:37.802206,0,820,1.0,10,0.4
2025-08-18T12:13:38.302899,0,820,1.0,10,0.4
2025-08-18T12:13:38.803442,0,820,1.0,10,1.3
2025-08-18T12:13:39.304124,0,820,1.0,10,0.3
2025-08-18T12:13:39.804821,0,820,1.0,10,0.3
2025-08-18T12:13:40.305501,0,820,1.0,10,0.7
2025-08-18T12:13:40.806292,0,820,1.0,10,0.1
2025-08-18T12:13:41.306986,0,820,1.0,10,0.2
2025-08-18T12:13:41.807741,0,820,1.0,10,0.1
2025-08-18T12:13:42.308497,0,820,1.0,10,0.1
2025-08-18T12:13:42.809271,0,820,1.0,10,0.1
2025-08-18T12:13:43.310026,0,820,1.0,10,0.2
2025-08-18T12:13:43.810683,0,820,1.0,10,0.5
2025-08-18T12:13:44.311328,0,820,1.0,10,0.2
2025-08-18T12:13:44.812048,0,820,1.0,10,0.2
2025-08-18T12:13:45.312823,0,820,1.0,10,0.2
2025-08-18T12:13:45.813460,0,820,1.0,10,0.1
2025-08-18T12:13:46.314052,0,820,1.0,10,0.1
2025-08-18T12:13:46.814700,0,820,1.0,10,0.3
2025-08-18T12:13:47.315290,0,820,1.0,10,0.1
2025-08-18T12:13:47.815628,0,820,1.0,10,2.5
2025-08-18T12:13:48.316142,0,820,1.0,10,1.0
2025-08-18T12:13:48.816711,0,820,1.0,10,0.6
2025-08-18T12:13:49.317234,0,820,1.0,10,0.7
2025-08-18T12:13:49.817763,0,820,1.0,10,0.4
2025-08-18T12:13:50.318256,0,820,1.0,10,0.3
2025-08-18T12:13:50.818775,0,820,1.0,10,0.4
2025-08-18T12:13:51.319256,0,820,1.0,10,0.2
2025-08-18T12:13:51.819735,0,820,1.0,10,0.3
2025-08-18T12:13:52.320194,0,820,1.0,10,0.3
2025-08-18T12:13:52.820692,0,820,1.0,10,0.4
2025-08-18T12:13:53.321151,0,820,1.0,10,0.3
2025-08-18T12:13:53.821655,0,820,1.0,10,0.5
2025-08-18T12:13:54.322116,0,820,1.0,10,0.2
2025-08-18T12:13:54.822598,0,820,1.0,10,0.3
2025-08-18T12:13:55.323094,0,820,1.0,10,0.4
2025-08-18T12:13:55.823566,0,820,1.0,10,0.3
2025-08-18T12:13:56.324025,0,820,1.0,10,0.3
2025-08-18T12:13:56.824492,0,820,1.0,10,0.3
2025-08-18T12:13:57.324964,0,820,1.0,10,0.3
2025-08-18T12:13:57.825475,0,820,1.0,10,0.3
2025-08-18T12:13:58.325968,0,820,1.0,10,0.2
2025-08-18T12:13:58.826466,0,820,1.0,10,0.3
2025-08-18T12:13:59.326961,0,820,1.0,10,0.2
2025-08-18T12:13:59.827430,0,820,1.0,10,0.1
2025-08-18T12:14:00.327856,0,820,1.0,10,0.3
2025-08-18T12:14:00.828409,0,820,1.0,10,2.3
2025-08-18T12:14:01.328910,0,820,1.0,10,0.3
2025-08-18T12:14:01.829366,0,820,1.0,10,0.3
2025-08-18T12:14:02.329913,0,820,1.0,10,1.2
2025-08-18T12:14:02.830408,0,820,1.0,10,0.3
2025-08-18T12:14:03.330916,0,820,1.0,10,0.3
2025-08-18T12:14:03.831388,0,820,1.0,10,0.6
2025-08-18T12:14:04.331791,0,820,1.0,10,1.9
2025-08-18T12:14:04.832358,0,820,1.0,10,5.4
2025-08-18T12:14:05.332962,0,820,1.0,10,7.3
2025-08-18T12:14:05.833541,0,820,1.0,10,4.2
2025-08-18T12:14:06.334088,0,820,1.0,10,1.6
2025-08-18T12:14:06.834499,0,820,1.0,10,2.8
2025-08-18T12:14:07.335070,0,820,1.0,10,1.8
2025-08-18T12:14:07.835692,0,820,1.0,10,2.6
2025-08-18T12:14:08.336263,0,820,1.0,10,1.9
2025-08-18T12:14:08.836841,0,820,1.0,10,1.1
2025-08-18T12:14:09.337479,0,820,1.0,10,4.1
2025-08-18T12:14:09.838031,0,820,1.0,10,1.3
2025-08-18T12:14:10.338591,0,820,1.0,10,1.1
2025-08-18T12:14:10.839148,0,820,1.0,10,1.3
2025-08-18T12:14:11.339739,0,820,1.0,10,0.9
2025-08-18T12:14:11.840255,0,820,1.0,10,0.3
2025-08-18T12:14:12.340822,0,820,1.0,10,0.6
2025-08-18T12:14:12.841395,0,820,1.0,10,3.9
2025-08-18T12:14:13.341920,0,820,1.0,10,0.2
2025-08-18T12:14:13.842441,0,820,1.0,10,0.3
2025-08-18T12:14:14.342984,0,820,1.0,10,0.4
2025-08-18T12:14:14.843491,0,820,1.0,10,0.2
2025-08-18T12:14:15.344082,0,820,1.0,10,1.3
2025-08-18T12:14:15.844653,0,820,1.0,10,1.9
2025-08-18T12:14:16.345227,0,820,1.0,10,0.6
2025-08-18T12:14:16.845819,0,820,1.0,10,1.4
2025-08-18T12:14:17.346454,0,820,1.0,10,1.4
2025-08-18T12:14:17.847148,0,820,1.0,10,1.1
2025-08-18T12:14:18.347803,0,820,1.0,10,3.6
2025-08-18T12:14:18.848623,0,820,1.0,10,0.3
2025-08-18T12:14:19.349401,0,820,1.0,10,0.3
2025-08-18T12:14:19.850092,0,820,1.0,10,0.3
2025-08-18T12:14:20.350908,0,820,1.0,10,0.3
2025-08-18T12:14:20.851645,0,820,1.0,10,0.2
2025-08-18T12:14:21.352449,0,820,1.0,10,0.4
2025-08-18T12:14:21.853310,0,820,1.0,10,0.2
2025-08-18T12:14:22.354109,0,820,1.0,10,0.2
2025-08-18T12:14:22.854962,0,820,1.0,10,0.3
2025-08-18T12:14:23.355717,0,820,1.0,10,0.2
2025-08-18T12:14:23.856471,0,820,1.0,10,0.2
2025-08-18T12:14:24.357266,0,820,1.0,10,0.3
2025-08-18T12:14:24.858070,0,820,1.0,10,0.2
2025-08-18T12:14:25.358809,0,820,1.0,10,0.3
2025-08-18T12:14:25.859426,0,820,1.0,10,0.3
2025-08-18T12:14:26.360084,0,820,1.0,10,2.7
2025-08-18T12:14:26.860668,0,820,1.0,10,2.1
2025-08-18T12:14:27.361295,0,820,1.0,10,0.2
2025-08-18T12:14:27.861990,0,820,1.0,10,0.3
2025-08-18T12:14:28.362650,0,820,1.0,10,0.3
2025-08-18T12:14:28.863280,0,820,1.0,10,0.4
2025-08-18T12:14:29.364023,0,820,1.0,10,0.3
2025-08-18T12:14:29.864771,0,820,1.0,10,0.1
2025-08-18T12:14:30.365378,0,820,1.0,10,0.2
2025-08-18T12:14:30.866096,0,820,1.0,10,0.3
2025-08-18T12:14:31.366863,0,820,1.0,10,0.2
2025-08-18T12:14:31.867458,0,820,1.0,10,0.3
2025-08-18T12:14:32.368178,0,820,1.0,10,0.3
2025-08-18T12:14:32.868847,0,820,1.0,10,0.2
2025-08-18T12:14:33.369728,0,820,1.0,10,0.4
2025-08-18T12:14:33.870482,0,820,1.0,10,0.4
2025-08-18T12:14:34.371219,0,820,1.0,10,0.3
2025-08-18T12:14:34.872027,0,820,1.0,10,0.2
2025-08-18T12:14:35.372842,0,820,1.0,10,0.4
2025-08-18T12:14:35.873641,0,820,1.0,10,0.1
2025-08-18T12:14:36.374394,0,820,1.0,10,0.2
2025-08-18T12:14:36.875132,0,820,1.0,10,0.2
2025-08-18T12:14:37.375923,0,820,1.0,10,0.3
2025-08-18T12:14:37.876614,0,820,1.0,10,0.6
2025-08-18T12:14:38.377322,0,820,1.0,10,0.4
2025-08-18T12:14:38.877970,0,820,1.0,10,0.8
2025-08-18T12:14:39.378705,0,820,1.0,10,0.2
2025-08-18T12:14:39.879272,0,820,1.0,10,0.4
2025-08-18T12:14:40.379985,0,820,1.0,10,0.3
2025-08-18T12:14:40.880739,0,820,1.0,10,0.2
2025-08-18T12:14:41.381423,0,820,1.0,10,0.3
2025-08-18T12:14:41.882099,0,820,1.0,10,0.1
2025-08-18T12:14:42.382861,0,820,1.0,10,0.3
2025-08-18T12:14:42.883494,0,820,1.0,10,0.3
2025-08-18T12:14:43.384260,0,820,1.0,10,0.7
2025-08-18T12:14:43.884951,0,820,1.0,10,0.3
2025-08-18T12:14:44.385900,0,820,1.0,10,0.3
2025-08-18T12:14:44.886603,0,820,1.0,10,0.1
2025-08-18T12:14:45.387377,0,820,1.0,10,0.4
2025-08-18T12:14:45.888280,0,820,1.0,10,0.3
2025-08-18T12:14:46.389028,0,820,1.0,10,0.3
2025-08-18T12:14:46.889796,0,820,1.0,10,0.1
2025-08-18T12:14:47.390558,0,820,1.0,10,0.3
2025-08-18T12:14:47.891291,0,820,1.0,10,0.3
2025-08-18T12:14:48.392104,0,820,1.0,10,0.2
2025-08-18T12:14:48.892920,0,820,1.0,10,0.4
2025-08-18T12:14:49.393760,0,820,1.0,10,0.6
2025-08-18T12:14:49.894543,0,820,1.0,10,0.4
2025-08-18T12:14:50.395356,0,820,1.0,10,0.2
2025-08-18T12:14:50.896103,0,820,1.0,10,0.3
2025-08-18T12:14:51.396884,0,820,1.0,10,0.1
2025-08-18T12:14:51.897677,0,820,1.0,10,0.2
2025-08-18T12:14:52.398457,0,820,1.0,10,0.2
2025-08-18T12:14:52.899245,0,820,1.0,10,0.3
2025-08-18T12:14:53.399971,0,820,1.0,10,0.2
2025-08-18T12:14:53.900689,0,820,1.0,10,0.3
2025-08-18T12:14:54.401415,0,820,1.0,10,0.2
2025-08-18T12:14:54.902233,0,820,1.0,10,0.2
2025-08-18T12:14:55.402977,0,820,1.0,10,0.3
2025-08-18T12:14:55.903797,0,820,1.0,10,0.2
2025-08-18T12:14:56.404636,0,820,1.0,10,0.2
2025-08-18T12:14:56.905227,0,820,1.0,10,0.3
2025-08-18T12:14:57.406094,0,820,1.0,10,0.1
2025-08-18T12:14:57.906903,0,820,1.0,10,0.3
2025-08-18T12:14:58.407614,0,820,1.0,10,0.2
2025-08-18T12:14:58.908229,0,820,1.0,10,0.4
2025-08-18T12:14:59.408868,0,820,1.0,10,0.2
2025-08-18T12:14:59.909495,0,820,1.0,10,0.3
2025-08-18T12:15:00.410167,0,820,1.0,10,0.1
2025-08-18T12:15:00.910909,0,820,1.0,10,0.9
2025-08-18T12:15:01.411628,0,820,1.0,10,0.3
2025-08-18T12:15:01.912382,0,820,1.0,10,0.3
2025-08-18T12:15:02.413097,0,820,1.0,10,0.2
2025-08-18T12:15:02.913727,0,820,1.0,10,0.4
2025-08-18T12:15:03.414403,0,820,1.0,10,0.4
2025-08-18T12:15:03.915076,0,820,1.0,10,0.4
2025-08-18T12:15:04.415791,0,820,1.0,10,0.3
2025-08-18T12:15:04.916436,0,820,1.0,10,0.3
2025-08-18T12:15:05.417046,0,820,1.0,10,0.3
2025-08-18T12:15:05.917646,0,820,1.0,10,0.3
2025-08-18T12:15:06.418313,0,820,1.0,10,0.3
2025-08-18T12:15:06.919060,0,820,1.0,10,0.2
2025-08-18T12:15:07.419779,0,820,1.0,10,0.3
2025-08-18T12:15:07.920312,0,820,1.0,10,0.4
2025-08-18T12:15:08.421032,0,820,1.0,10,0.4
2025-08-18T12:15:08.921626,0,820,1.0,10,2.6
2025-08-18T12:15:09.422358,0,820,1.0,10,0.4
2025-08-18T12:15:09.923183,0,820,1.0,10,0.3
2025-08-18T12:15:10.423967,0,820,1.0,10,0.4
2025-08-18T12:15:10.924726,0,820,1.0,10,0.3
2025-08-18T12:15:11.425448,0,820,1.0,10,0.2
2025-08-18T12:15:11.926040,0,820,1.0,10,0.3
2025-08-18T12:15:12.426780,0,820,1.0,10,0.1
2025-08-18T12:15:12.927488,0,820,1.0,10,0.3
2025-08-18T12:15:13.428092,0,820,1.0,10,0.3
2025-08-18T12:15:13.928871,0,820,1.0,10,0.5
2025-08-18T12:15:14.429684,0,820,1.0,10,0.2
2025-08-18T12:15:14.930454,0,820,1.0,10,0.3
2025-08-18T12:15:15.431266,0,820,1.0,10,0.2
2025-08-18T12:15:15.932073,0,820,1.0,10,0.2
2025-08-18T12:15:16.432780,0,820,1.0,10,0.1
2025-08-18T12:15:16.933582,0,820,1.0,10,0.2
2025-08-18T12:15:17.434637,0,820,1.0,10,0.2
2025-08-18T12:15:17.935259,0,820,1.0,10,0.3
2025-08-18T12:15:18.435978,0,820,1.0,10,0.2
2025-08-18T12:15:18.936603,0,820,1.0,10,0.4
2025-08-18T12:15:19.437221,0,820,1.0,10,0.3
2025-08-18T12:15:19.937956,0,820,1.0,10,0.4
2025-08-18T12:15:20.438694,0,820,1.0,10,0.3
2025-08-18T12:15:20.939312,0,820,1.0,10,0.3
2025-08-18T12:15:21.440048,0,820,1.0,10,0.1
2025-08-18T12:15:21.940816,0,820,1.0,10,0.3
2025-08-18T12:15:22.441541,0,820,1.0,10,0.3
2025-08-18T12:15:22.942273,0,820,1.0,10,0.3
2025-08-18T12:15:23.443062,0,820,1.0,10,0.2
2025-08-18T12:15:23.943634,0,820,1.0,10,0.3
2025-08-18T12:15:24.444393,0,820,1.0,10,0.2
2025-08-18T12:15:24.945155,0,820,1.0,10,0.2
2025-08-18T12:15:25.445911,0,820,1.0,10,0.2
2025-08-18T12:15:25.946680,0,820,1.0,10,0.2
2025-08-18T12:15:26.447424,0,820,1.0,10,0.2
2025-08-18T12:15:26.948196,0,820,1.0,10,0.2
2025-08-18T12:15:27.448972,0,820,1.0,10,0.1
2025-08-18T12:15:27.949699,0,820,1.0,10,0.7
2025-08-18T12:15:28.450423,0,820,1.0,10,0.3
2025-08-18T12:15:28.950973,0,820,1.0,10,0.6
2025-08-18T12:15:29.451728,0,820,1.0,10,0.2
2025-08-18T12:15:29.952474,0,820,1.0,10,0.3
2025-08-18T12:15:30.453244,0,820,1.0,10,0.2
2025-08-18T12:15:30.954024,0,820,1.0,10,0.2
2025-08-18T12:15:31.454849,0,820,1.0,10,0.2
2025-08-18T12:15:31.955604,0,820,1.0,10,0.1
2025-08-18T12:15:32.456351,0,820,1.0,10,0.3
2025-08-18T12:15:32.957077,0,820,1.0,10,0.4
2025-08-18T12:15:33.457812,0,820,1.0,10,0.1
2025-08-18T12:15:33.958845,0,820,1.0,10,0.3
2025-08-18T12:15:34.459471,0,820,1.0,10,0.3
2025-08-18T12:15:34.960102,0,820,1.0,10,0.2
2025-08-18T12:15:35.460737,0,820,1.0,10,0.3
2025-08-18T12:15:35.961354,0,820,1.0,10,0.2
2025-08-18T12:15:36.462119,0,820,1.0,10,0.2
2025-08-18T12:15:36.962863,0,820,1.0,10,0.1
2025-08-18T12:15:37.463473,0,820,1.0,10,0.2
2025-08-18T12:15:37.963817,0,820,1.0,10,1.1
2025-08-18T12:15:38.464154,0,820,1.0,10,5.4
2025-08-18T12:15:38.964772,0,820,1.0,10,1.1
2025-08-18T12:15:39.465142,0,820,1.0,10,2.7
2025-08-18T12:15:39.965700,0,820,1.0,10,1.4
2025-08-18T12:15:40.466468,0,820,1.0,10,0.4
2025-08-18T12:15:40.967168,0,820,1.0,10,0.2
2025-08-18T12:15:41.467609,0,820,1.0,10,5.8
2025-08-18T12:15:41.968297,0,820,1.0,10,0.7
2025-08-18T12:15:42.468989,0,820,1.0,10,0.6
2025-08-18T12:15:42.969566,0,820,1.0,10,0.8
2025-08-18T12:15:43.470280,0,820,1.0,10,4.7
2025-08-18T12:15:43.970941,0,820,1.0,10,2.1
2025-08-18T12:15:44.471503,0,820,1.0,10,0.9
2025-08-18T12:15:44.971802,0,820,1.0,10,3.8
2025-08-18T12:15:45.472128,0,820,1.0,10,5.9
2025-08-18T12:15:45.972397,0,820,1.0,10,5.7
2025-08-18T12:15:46.472966,0,820,1.0,10,3.0
2025-08-18T12:15:46.973617,0,820,1.0,10,3.3
2025-08-18T12:15:47.473921,0,820,1.0,10,1.7
2025-08-18T12:15:47.974594,0,820,1.0,10,3.5
2025-08-18T12:15:48.474989,0,820,1.0,10,4.4
2025-08-18T12:15:48.975536,0,820,1.0,10,5.7
2025-08-18T12:15:49.476091,0,820,1.0,10,5.7
2025-08-18T12:15:49.976707,0,820,1.0,10,4.8
2025-08-18T12:15:50.477031,0,820,1.0,10,5.5
2025-08-18T12:15:50.977279,0,820,1.0,10,5.0
2025-08-18T12:15:51.477562,0,820,1.0,10,5.3
2025-08-18T12:15:51.978283,0,820,1.0,10,1.2
2025-08-18T12:15:52.479040,0,820,1.0,10,0.3
2025-08-18T12:15:52.979503,0,820,1.0,10,0.7
2025-08-18T12:15:53.480092,0,820,1.0,10,2.6
2025-08-18T12:15:53.980873,0,820,1.0,10,0.4
2025-08-18T12:15:54.481470,0,820,1.0,10,1.6
2025-08-18T12:15:54.982266,0,820,1.0,10,0.3
2025-08-18T12:15:55.482845,0,820,1.0,10,0.5
2025-08-18T12:15:55.983395,0,820,1.0,10,6.2
2025-08-18T12:15:56.483962,0,820,1.0,10,4.4
2025-08-18T12:15:56.984267,0,820,1.0,10,4.0
2025-08-18T12:15:57.484771,0,820,1.0,10,3.6
2025-08-18T12:15:57.985141,0,820,1.0,10,2.2
2025-08-18T12:15:58.485399,0,820,1.0,10,6.1
2025-08-18T12:15:58.985961,0,820,1.0,10,5.1
2025-08-18T12:15:59.486372,0,820,1.0,10,3.0
2025-08-18T12:15:59.986823,0,820,1.0,10,4.7
2025-08-18T12:16:00.487412,0,820,1.0,10,6.0
2025-08-18T12:16:00.988076,0,820,1.0,10,2.8
2025-08-18T12:16:01.488436,0,820,1.0,10,0.8
2025-08-18T12:16:01.988656,0,820,1.0,10,3.2
2025-08-18T12:16:02.489151,0,820,1.0,10,5.5
2025-08-18T12:16:02.989663,0,820,1.0,10,4.1
2025-08-18T12:16:03.489907,0,820,1.0,10,3.7
2025-08-18T12:16:03.990148,0,820,1.0,10,8.9
2025-08-18T12:16:04.490422,0,820,1.0,10,11.3
2025-08-18T12:16:04.990929,0,820,1.0,10,14.5
2025-08-18T12:16:05.491568,0,820,1.0,10,6.1
2025-08-18T12:16:05.992123,0,820,1.0,10,1.4
2025-08-18T12:16:06.492678,0,820,1.0,10,4.1
2025-08-18T12:16:06.993197,0,820,1.0,10,1.5
2025-08-18T12:16:07.493751,0,820,1.0,10,2.4
2025-08-18T12:16:07.994278,0,820,1.0,10,1.2
2025-08-18T12:16:08.494824,0,820,1.0,10,1.4
2025-08-18T12:16:08.995368,0,820,1.0,10,1.7
2025-08-18T12:16:09.495899,0,820,1.0,10,1.3
2025-08-18T12:16:09.996742,0,820,1.0,10,2.6
2025-08-18T12:16:10.497325,0,820,1.0,10,3.2
2025-08-18T12:16:10.997889,0,820,1.0,10,1.9
2025-08-18T12:16:11.498465,0,820,1.0,10,3.9
2025-08-18T12:16:11.999028,0,820,1.0,10,5.1
2025-08-18T12:16:12.499597,0,820,1.0,10,1.9
2025-08-18T12:16:12.999918,0,820,1.0,10,4.1
2025-08-18T12:16:13.500456,0,820,1.0,10,4.2
2025-08-18T12:16:14.000756,0,820,1.0,10,4.5
2025-08-18T12:16:14.501092,0,820,1.0,10,4.9
2025-08-18T12:16:15.001605,0,820,1.0,10,4.5
2025-08-18T12:16:15.502160,0,820,1.0,10,0.5
2025-08-18T12:16:16.002637,0,820,1.0,10,2.9
2025-08-18T12:16:16.503215,0,820,1.0,10,2.4
2025-08-18T12:16:17.003588,0,820,1.0,10,3.6
2025-08-18T12:16:17.504206,0,820,1.0,10,1.3
2025-08-18T12:16:18.004710,0,820,1.0,10,2.1
2025-08-18T12:16:18.505302,0,820,1.0,10,2.1
2025-08-18T12:16:19.005896,0,820,1.0,10,5.0
2025-08-18T12:16:19.506256,0,820,1.0,10,2.6
2025-08-18T12:16:20.006797,0,820,1.0,10,2.3
2025-08-18T12:16:20.507366,0,820,1.0,10,3.6
2025-08-18T12:16:21.008023,0,820,1.0,10,0.5
2025-08-18T12:16:21.508679,0,820,1.0,10,0.4
2025-08-18T12:16:22.009237,0,820,1.0,10,0.4
2025-08-18T12:16:22.509731,0,820,1.0,10,0.4
2025-08-18T12:16:23.010255,0,820,1.0,10,0.6
2025-08-18T12:16:23.510746,0,820,1.0,10,0.4
2025-08-18T12:16:24.011342,0,820,1.0,10,1.4
2025-08-18T12:16:24.511946,0,820,1.0,10,0.6
2025-08-18T12:16:25.012595,0,820,1.0,10,0.7
2025-08-18T12:16:25.513198,0,820,1.0,10,0.6
2025-08-18T12:16:26.013794,0,820,1.0,10,0.5
2025-08-18T12:16:26.514346,0,820,1.0,10,0.5
2025-08-18T12:16:27.014945,0,820,1.0,10,0.7
2025-08-18T12:16:27.515504,0,820,1.0,10,0.4
2025-08-18T12:16:28.016039,0,820,1.0,10,0.7
2025-08-18T12:16:28.516612,0,820,1.0,10,0.4
2025-08-18T12:16:29.017215,0,820,1.0,10,0.5
2025-08-18T12:16:29.517785,0,820,1.0,10,0.4
2025-08-18T12:16:30.018372,0,820,1.0,10,0.4
2025-08-18T12:16:30.518884,0,820,1.0,10,0.6
2025-08-18T12:16:31.019367,0,820,1.0,10,0.4
2025-08-18T12:16:31.519851,0,820,1.0,10,0.4
2025-08-18T12:16:32.020549,0,820,1.0,10,0.6
2025-08-18T12:16:32.521156,0,820,1.0,10,0.4
2025-08-18T12:16:33.021787,0,820,1.0,10,0.5
2025-08-18T12:16:33.522397,0,820,1.0,10,0.4
2025-08-18T12:16:34.022910,0,820,1.0,10,1.3
2025-08-18T12:16:34.523506,0,820,1.0,10,0.4
2025-08-18T12:16:35.024106,0,820,1.0,10,3.8
2025-08-18T12:16:35.524807,0,820,1.0,10,3.1
2025-08-18T12:16:36.025370,0,820,1.0,10,1.0
2025-08-18T12:16:36.526000,0,820,1.0,10,0.7
2025-08-18T12:16:37.026494,0,820,1.0,10,0.4
2025-08-18T12:16:37.527132,0,820,1.0,10,0.3
2025-08-18T12:16:38.027732,0,820,1.0,10,0.6
2025-08-18T12:16:38.528309,0,820,1.0,10,0.9
2025-08-18T12:16:39.028902,0,820,1.0,10,0.6
2025-08-18T12:16:39.529435,0,820,1.0,10,1.0
2025-08-18T12:16:40.030059,0,820,1.0,10,0.6
2025-08-18T12:16:40.530661,0,820,1.0,10,0.5
2025-08-18T12:16:41.031216,0,820,1.0,10,0.4
2025-08-18T12:16:41.531765,0,820,1.0,10,0.4
2025-08-18T12:16:42.032316,0,820,1.0,10,0.4
2025-08-18T12:16:42.532951,0,820,1.0,10,0.5
2025-08-18T12:16:43.033465,0,820,1.0,10,0.3
2025-08-18T12:16:43.534070,0,820,1.0,10,1.4
2025-08-18T12:16:44.034383,0,820,1.0,10,1.1
2025-08-18T12:16:44.534940,0,820,1.0,10,0.4
2025-08-18T12:16:45.035479,0,820,1.0,10,0.6
2025-08-18T12:16:45.536126,0,820,1.0,10,0.6
2025-08-18T12:16:46.036725,0,820,1.0,10,0.4
2025-08-18T12:16:46.537367,0,820,1.0,10,0.6
2025-08-18T12:16:47.037933,0,820,1.0,10,0.4
2025-08-18T12:16:47.538342,0,820,1.0,10,1.5
2025-08-18T12:16:48.038892,0,820,1.0,10,3.5
2025-08-18T12:16:48.539455,0,820,1.0,10,2.1
2025-08-18T12:16:49.040069,0,820,1.0,10,3.7
2025-08-18T12:16:49.540895,0,820,1.0,10,1.1
2025-08-18T12:16:50.041448,0,820,1.0,10,1.6
2025-08-18T12:16:50.542017,0,820,1.0,10,1.3
2025-08-18T12:16:51.042603,0,820,1.0,10,0.8
2025-08-18T12:16:51.543163,0,820,1.0,10,0.9
2025-08-18T12:16:52.043756,0,820,1.0,10,0.8
2025-08-18T12:16:52.544298,0,820,1.0,10,1.7
2025-08-18T12:16:53.044827,0,820,1.0,10,0.6
2025-08-18T12:16:53.545403,0,820,1.0,10,0.6
2025-08-18T12:16:54.046017,0,820,1.0,10,0.6
2025-08-18T12:16:54.546584,0,820,1.0,10,0.6
2025-08-18T12:16:55.047049,0,820,1.0,10,0.4
2025-08-18T12:16:55.547570,0,820,1.0,10,0.6
2025-08-18T12:16:56.048063,0,820,1.0,10,0.4
2025-08-18T12:16:56.548628,0,820,1.0,10,0.4
2025-08-18T12:16:57.049163,0,820,1.0,10,0.4
2025-08-18T12:16:57.549707,0,820,1.0,10,0.3
2025-08-18T12:16:58.050306,0,820,1.0,10,0.6
2025-08-18T12:16:58.550873,0,820,1.0,10,0.4
2025-08-18T12:16:59.051456,0,820,1.0,10,0.4
2025-08-18T12:16:59.551957,0,820,1.0,10,0.6
2025-08-18T12:17:00.052488,0,820,1.0,10,0.4
2025-08-18T12:17:00.553088,0,820,1.0,10,0.9
2025-08-18T12:17:01.053348,0,820,1.0,10,5.0
2025-08-18T12:17:01.553610,0,820,1.0,10,2.3
2025-08-18T12:17:02.053829,0,820,1.0,10,2.9
2025-08-18T12:17:02.554391,0,820,1.0,10,3.3
2025-08-18T12:17:03.055072,0,820,1.0,10,1.8
2025-08-18T12:17:03.555799,0,820,1.0,10,1.1
2025-08-18T12:17:04.056385,0,820,1.0,10,2.3
2025-08-18T12:17:04.556961,0,820,1.0,10,3.0
2025-08-18T12:17:05.057602,0,820,1.0,10,0.8
2025-08-18T12:17:05.557914,0,820,1.0,10,1.2
2025-08-18T12:17:06.058445,0,820,1.0,10,2.3
2025-08-18T12:17:06.559050,0,820,1.0,10,0.6
2025-08-18T12:17:07.059584,0,820,1.0,10,0.5
2025-08-18T12:17:07.560246,0,820,1.0,10,0.5
2025-08-18T12:17:08.060837,0,820,1.0,10,0.4
2025-08-18T12:17:08.561436,0,820,1.0,10,0.7
2025-08-18T12:17:09.062056,0,820,1.0,10,0.6
2025-08-18T12:17:09.562691,0,820,1.0,10,0.9
2025-08-18T12:17:10.063338,0,820,1.0,10,0.8
2025-08-18T12:17:10.563756,0,820,1.0,10,0.7
2025-08-18T12:17:11.064316,0,820,1.0,10,0.6
2025-08-18T12:17:11.564886,0,820,1.0,10,0.4
2025-08-18T12:17:12.065437,0,820,1.0,10,4.2
2025-08-18T12:17:12.565960,0,820,1.0,10,0.6
2025-08-18T12:17:13.066472,0,820,1.0,10,0.8
2025-08-18T12:17:13.566990,0,820,1.0,10,3.3
2025-08-18T12:17:14.067429,0,820,1.0,10,7.7
2025-08-18T12:17:14.568007,0,820,1.0,10,2.9
2025-08-18T12:17:15.068430,0,820,1.0,10,3.8
2025-08-18T12:17:15.568942,0,820,1.0,10,3.6
2025-08-18T12:17:16.069442,0,820,1.0,10,2.3
2025-08-18T12:17:16.570001,0,820,1.0,10,4.5
2025-08-18T12:17:17.070646,0,820,1.0,10,1.2
2025-08-18T12:17:17.571167,0,820,1.0,10,0.6
2025-08-18T12:17:18.071715,0,820,1.0,10,1.1
2025-08-18T12:17:18.572295,0,820,1.0,10,1.4
2025-08-18T12:17:19.072916,0,820,1.0,10,0.7
2025-08-18T12:17:19.573566,0,820,1.0,10,0.6
2025-08-18T12:17:20.074193,0,820,1.0,10,0.7
2025-08-18T12:17:20.575484,0,820,1.0,10,0.6
2025-08-18T12:17:21.075974,0,820,1.0,10,0.6
2025-08-18T12:17:21.576503,0,820,1.0,10,0.6
2025-08-18T12:17:22.076877,0,820,1.0,10,2.3
2025-08-18T12:17:22.577392,0,820,1.0,10,1.3
2025-08-18T12:17:23.077948,0,820,1.0,10,2.6
2025-08-18T12:17:23.578459,0,820,1.0,10,0.4
2025-08-18T12:17:24.079015,0,820,1.0,10,0.9
2025-08-18T12:17:24.579534,0,820,1.0,10,0.4
2025-08-18T12:17:25.080039,0,820,1.0,10,0.6
2025-08-18T12:17:25.580558,0,820,1.0,10,0.6
2025-08-18T12:17:26.081076,0,820,1.0,10,0.6
2025-08-18T12:17:26.581560,0,820,1.0,10,0.5
2025-08-18T12:17:27.082096,0,820,1.0,10,0.4
2025-08-18T12:17:27.582603,0,820,1.0,10,0.4
2025-08-18T12:17:28.083222,0,820,1.0,10,0.4
2025-08-18T12:17:28.583823,0,820,1.0,10,0.4
2025-08-18T12:17:29.084440,0,820,1.0,10,0.7
2025-08-18T12:17:29.584928,0,820,1.0,10,0.4
2025-08-18T12:17:30.085504,0,820,1.0,10,0.6
2025-08-18T12:17:30.585955,0,820,1.0,10,0.4
2025-08-18T12:17:31.086605,0,820,1.0,10,0.6
2025-08-18T12:17:31.587183,0,820,1.0,10,0.4
2025-08-18T12:17:32.087480,0,820,1.0,10,2.7
2025-08-18T12:17:32.588038,0,820,1.0,10,1.8
2025-08-18T12:17:33.088410,0,820,1.0,10,1.1
2025-08-18T12:17:33.589018,0,820,1.0,10,2.5
2025-08-18T12:17:34.089584,0,820,1.0,10,0.6
2025-08-18T12:17:34.590183,0,820,1.0,10,0.5
2025-08-18T12:17:35.090813,0,820,1.0,10,0.5
2025-08-18T12:17:35.591437,0,820,1.0,10,0.6
2025-08-18T12:17:36.092153,0,820,1.0,10,0.5
2025-08-18T12:17:36.592819,0,820,1.0,10,0.5
2025-08-18T12:17:37.093436,0,820,1.0,10,1.3
2025-08-18T12:17:37.594029,0,820,1.0,10,0.6
2025-08-18T12:17:38.094396,0,820,1.0,10,3.9
2025-08-18T12:17:38.594941,0,820,1.0,10,6.2
2025-08-18T12:17:39.095591,0,820,1.0,10,0.5
2025-08-18T12:17:39.596026,0,820,1.0,10,2.6
2025-08-18T12:17:40.096597,0,820,1.0,10,1.7
2025-08-18T12:17:40.597147,0,820,1.0,10,0.3
2025-08-18T12:17:41.097679,0,820,1.0,10,0.6
2025-08-18T12:17:41.598169,0,820,1.0,10,0.4
2025-08-18T12:17:42.098682,0,820,1.0,10,0.5
2025-08-18T12:17:42.599245,0,820,1.0,10,0.4
2025-08-18T12:17:43.099901,0,820,1.0,10,1.1
2025-08-18T12:17:43.600392,0,820,1.0,10,0.4
2025-08-18T12:17:44.101082,0,820,1.0,10,0.8
2025-08-18T12:17:44.601775,0,820,1.0,10,0.9
2025-08-18T12:17:45.102344,0,820,1.0,10,0.4
2025-08-18T12:17:45.602956,0,820,1.0,10,0.7
2025-08-18T12:17:46.103311,0,820,1.0,10,3.4
2025-08-18T12:17:46.604148,0,820,1.0,10,2.7
2025-08-18T12:17:47.104615,0,820,1.0,10,1.7
2025-08-18T12:17:47.605227,0,820,1.0,10,3.3
2025-08-18T12:17:48.105801,0,820,1.0,10,4.1
2025-08-18T12:17:48.606107,0,820,1.0,10,2.3
2025-08-18T12:17:49.106539,0,820,1.0,10,2.2
2025-08-18T12:17:49.607359,0,820,1.0,10,2.8
2025-08-18T12:17:50.107795,0,820,1.0,10,2.8
2025-08-18T12:17:50.608439,0,820,1.0,10,3.6
2025-08-18T12:17:51.108768,0,820,1.0,10,3.4
2025-08-18T12:17:51.609014,0,820,1.0,10,2.6
2025-08-18T12:17:52.109489,0,820,1.0,10,2.6
2025-08-18T12:17:52.610084,0,820,1.0,10,2.6
2025-08-18T12:17:53.110730,0,820,1.0,10,1.0
2025-08-18T12:17:53.611259,0,820,1.0,10,1.9
2025-08-18T12:17:54.111885,0,820,1.0,10,1.1
2025-08-18T12:17:54.612401,0,820,1.0,10,2.4
2025-08-18T12:17:55.112777,0,820,1.0,10,4.6
2025-08-18T12:17:55.613035,0,820,1.0,10,2.5
2025-08-18T12:17:56.113467,0,820,1.0,10,3.3
2025-08-18T12:17:56.614040,0,820,1.0,10,4.4
2025-08-18T12:17:57.114463,0,820,1.0,10,3.6
2025-08-18T12:17:57.615032,0,820,1.0,10,1.6
2025-08-18T12:17:58.115611,0,820,1.0,10,0.9
2025-08-18T12:17:58.616160,0,820,1.0,10,0.4
2025-08-18T12:17:59.116718,0,820,1.0,10,1.6
2025-08-18T12:17:59.617359,0,820,1.0,10,2.9
2025-08-18T12:18:00.117951,0,820,1.0,10,0.6
2025-08-18T12:18:00.618544,0,820,1.0,10,0.5
2025-08-18T12:18:01.119155,0,820,1.0,10,0.9
2025-08-18T12:18:01.619703,0,820,1.0,10,1.3
2025-08-18T12:18:02.120257,0,820,1.0,10,0.4
2025-08-18T12:18:02.620822,0,820,1.0,10,0.4
2025-08-18T12:18:03.121435,0,820,1.0,10,0.5
2025-08-18T12:18:03.622058,0,820,1.0,10,0.5
2025-08-18T12:18:04.122667,0,820,1.0,10,0.5
2025-08-18T12:18:04.623184,0,820,1.0,10,0.5
2025-08-18T12:18:05.123769,0,820,1.0,10,0.4
2025-08-18T12:18:05.624327,0,820,1.0,10,0.4
2025-08-18T12:18:06.124598,0,820,1.0,10,2.8
2025-08-18T12:18:06.624913,0,820,1.0,10,7.3
2025-08-18T12:18:07.125247,0,820,1.0,10,5.1
2025-08-18T12:18:07.625768,0,820,1.0,10,6.9
2025-08-18T12:18:08.126130,0,820,1.0,10,7.4
2025-08-18T12:18:08.626422,0,820,1.0,10,6.3
2025-08-18T12:18:09.127225,0,820,1.0,10,4.6
2025-08-18T12:18:09.627844,0,820,1.0,10,1.6
2025-08-18T12:18:10.128661,0,820,1.0,10,4.3
2025-08-18T12:18:10.629626,0,820,1.0,10,1.6
2025-08-18T12:18:11.130262,0,820,1.0,10,1.6
2025-08-18T12:18:11.630857,0,820,1.0,10,2.4
2025-08-18T12:18:12.131375,0,820,1.0,10,2.9
2025-08-18T12:18:12.631985,0,820,1.0,10,5.6
2025-08-18T12:18:13.132576,0,820,1.0,10,1.1
2025-08-18T12:18:13.632890,0,820,1.0,10,3.6
2025-08-18T12:18:14.133413,0,820,1.0,10,1.6
2025-08-18T12:18:14.633984,0,820,1.0,10,1.1
2025-08-18T12:18:15.134462,0,820,1.0,10,1.1
2025-08-18T12:18:15.635049,0,820,1.0,10,1.1
2025-08-18T12:18:16.135684,0,820,1.0,10,0.9
2025-08-18T12:18:16.636292,0,820,1.0,10,1.0
2025-08-18T12:18:17.136922,0,820,1.0,10,1.1
2025-08-18T12:18:17.637539,0,820,1.0,10,1.1
2025-08-18T12:18:18.138075,0,820,1.0,10,2.4
2025-08-18T12:18:18.638675,0,820,1.0,10,1.7
2025-08-18T12:18:19.139197,0,820,1.0,10,1.5
2025-08-18T12:18:19.639833,0,820,1.0,10,1.3
2025-08-18T12:18:20.140463,0,820,1.0,10,1.3
2025-08-18T12:18:20.641053,0,820,1.0,10,1.2
2025-08-18T12:18:21.141726,0,820,1.0,10,1.4
2025-08-18T12:18:21.642348,0,820,1.0,10,1.6
2025-08-18T12:18:22.142881,0,820,1.0,10,2.1
2025-08-18T12:18:22.643299,0,820,1.0,10,5.1
2025-08-18T12:18:23.143931,0,820,1.0,10,3.4
2025-08-18T12:18:23.644464,0,820,1.0,10,4.6
2025-08-18T12:18:24.145008,0,820,1.0,10,1.8
2025-08-18T12:18:24.645444,0,820,1.0,10,4.1
2025-08-18T12:18:25.145918,0,820,1.0,10,1.8
2025-08-18T12:18:25.646398,0,820,1.0,10,0.9
2025-08-18T12:18:26.146907,0,820,1.0,10,0.9
2025-08-18T12:18:26.647391,0,820,1.0,10,1.0
2025-08-18T12:18:27.147853,0,820,1.0,10,1.1
2025-08-18T12:18:27.648461,0,820,1.0,10,1.8
2025-08-18T12:18:28.149113,0,820,1.0,10,0.9
2025-08-18T12:18:28.649661,0,820,1.0,10,0.9
2025-08-18T12:18:29.150182,0,820,1.0,10,1.1
2025-08-18T12:18:29.650705,0,820,1.0,10,1.0
2025-08-18T12:18:30.151186,0,820,1.0,10,0.9
2025-08-18T12:18:30.651691,0,820,1.0,10,1.0
2025-08-18T12:18:31.152197,0,820,1.0,10,1.0
2025-08-18T12:18:31.652735,0,820,1.0,10,1.2
2025-08-18T12:18:32.153265,0,820,1.0,10,1.1
2025-08-18T12:18:32.653826,0,820,1.0,10,2.2
2025-08-18T12:18:33.154230,0,820,1.0,10,5.5
2025-08-18T12:18:33.654497,0,820,1.0,10,1.8
2025-08-18T12:18:34.154717,0,820,1.0,10,5.1
2025-08-18T12:18:34.655231,0,820,1.0,10,4.2
2025-08-18T12:18:35.155806,0,820,1.0,10,2.7
2025-08-18T12:18:35.656346,0,820,1.0,10,2.4
2025-08-18T12:18:36.156941,0,820,1.0,10,2.1
2025-08-18T12:18:36.657489,0,820,1.0,10,1.3
2025-08-18T12:18:37.157821,0,820,1.0,10,5.8
2025-08-18T12:18:37.658044,0,820,1.0,10,6.3
2025-08-18T12:18:38.158472,0,820,1.0,10,4.5
2025-08-18T12:18:38.659005,0,820,1.0,10,3.5
2025-08-18T12:18:39.159445,0,820,1.0,10,5.3
2025-08-18T12:18:39.660002,0,820,1.0,10,4.0
2025-08-18T12:18:40.160279,0,820,1.0,10,5.4
2025-08-18T12:18:40.660941,0,820,1.0,10,4.9
2025-08-18T12:18:41.161504,0,820,1.0,10,5.0
2025-08-18T12:18:41.662169,0,820,1.0,10,3.1
2025-08-18T12:18:42.162757,0,820,1.0,10,5.9
2025-08-18T12:18:42.663257,0,820,1.0,10,4.1
2025-08-18T12:18:43.163539,0,820,1.0,10,5.0
2025-08-18T12:18:43.663777,0,820,1.0,10,6.8
2025-08-18T12:18:44.164039,0,820,1.0,10,4.9
2025-08-18T12:18:44.664360,0,820,1.0,10,2.4
2025-08-18T12:18:45.164812,0,820,1.0,10,5.5
2025-08-18T12:18:45.665104,0,820,1.0,10,4.7
2025-08-18T12:18:46.165354,0,820,1.0,10,5.6
2025-08-18T12:18:46.665735,0,820,1.0,10,5.1
2025-08-18T12:18:47.166057,0,820,1.0,10,4.3
2025-08-18T12:18:47.666389,0,820,1.0,10,4.3
2025-08-18T12:18:48.166740,0,820,1.0,10,5.2
2025-08-18T12:18:48.667085,0,820,1.0,10,4.2
2025-08-18T12:18:49.167794,0,820,1.0,10,5.6
2025-08-18T12:18:49.668203,0,820,1.0,10,4.9
2025-08-18T12:18:50.168526,0,820,1.0,10,5.2
2025-08-18T12:18:50.669102,0,820,1.0,10,3.8
2025-08-18T12:18:51.169735,0,820,1.0,10,4.0
2025-08-18T12:18:51.670120,0,820,1.0,10,7.0
2025-08-18T12:18:52.170431,0,820,1.0,10,4.2
2025-08-18T12:18:52.670980,0,820,1.0,10,3.3
2025-08-18T12:18:53.171599,0,820,1.0,10,3.5
2025-08-18T12:18:53.671934,0,820,1.0,10,3.3
2025-08-18T12:18:54.172230,0,820,1.0,10,4.7
2025-08-18T12:18:54.672487,0,820,1.0,10,3.8
2025-08-18T12:18:55.172742,0,820,1.0,10,4.1
2025-08-18T12:18:55.673073,0,820,1.0,10,4.7
2025-08-18T12:18:56.173411,0,820,1.0,10,4.5
2025-08-18T12:18:56.673733,0,820,1.0,10,4.0
2025-08-18T12:18:57.174088,0,820,1.0,10,4.0
2025-08-18T12:18:57.674434,0,820,1.0,10,4.0
2025-08-18T12:18:58.174673,0,820,1.0,10,5.2
2025-08-18T12:18:58.675075,0,820,1.0,10,4.2
2025-08-18T12:18:59.175934,0,820,1.0,10,4.0
2025-08-18T12:18:59.676268,0,820,1.0,10,5.5
2025-08-18T12:19:00.176796,0,820,1.0,10,6.7
2025-08-18T12:19:00.677366,0,820,1.0,10,4.5
2025-08-18T12:19:01.177714,0,820,1.0,10,4.2
2025-08-18T12:19:01.677973,0,820,1.0,10,4.8
2025-08-18T12:19:02.178246,0,820,1.0,10,6.3
2025-08-18T12:19:02.678788,0,820,1.0,10,3.7
2025-08-18T12:19:03.179115,0,820,1.0,10,4.5
2025-08-18T12:19:03.679573,0,820,1.0,10,6.8
2025-08-18T12:19:04.180122,0,820,1.0,10,5.1
2025-08-18T12:19:04.680598,0,820,1.0,10,5.1
2025-08-18T12:19:05.181161,0,820,1.0,10,4.2
2025-08-18T12:19:05.681496,0,820,1.0,10,4.7
2025-08-18T12:19:06.182054,0,820,1.0,10,4.5
2025-08-18T12:19:06.682412,0,820,1.0,10,5.0
2025-08-18T12:19:07.182988,0,820,1.0,10,4.7
2025-08-18T12:19:07.683432,0,820,1.0,10,4.4
2025-08-18T12:19:08.183760,0,820,1.0,10,4.0
2025-08-18T12:19:08.684089,0,820,1.0,10,4.5
2025-08-18T12:19:09.184416,0,820,1.0,10,4.9
2025-08-18T12:19:09.684738,0,820,1.0,10,7.6
2025-08-18T12:19:10.185141,0,820,1.0,10,4.9
2025-08-18T12:19:10.685912,0,820,1.0,10,4.0
2025-08-18T12:19:11.186233,0,820,1.0,10,3.6
2025-08-18T12:19:11.686475,0,820,1.0,10,4.6
2025-08-18T12:19:12.186761,0,820,1.0,10,4.1
2025-08-18T12:19:12.687043,0,820,1.0,10,5.1
2025-08-18T12:19:13.187604,0,820,1.0,10,3.5
2025-08-18T12:19:13.688187,0,820,1.0,10,2.9
2025-08-18T12:19:14.188724,0,820,1.0,10,4.2
2025-08-18T12:19:14.689074,0,820,1.0,10,4.7
2025-08-18T12:19:15.189326,0,820,1.0,10,5.1
2025-08-18T12:19:15.689611,0,820,1.0,10,4.3
2025-08-18T12:19:16.189874,0,820,1.0,10,3.1
2025-08-18T12:19:16.690129,0,820,1.0,10,4.4
2025-08-18T12:19:17.190648,0,820,1.0,10,2.8
2025-08-18T12:19:17.691027,0,820,1.0,10,4.5
2025-08-18T12:19:18.191315,0,820,1.0,10,5.5
2025-08-18T12:19:18.691584,0,820,1.0,10,4.4
2025-08-18T12:19:19.191830,0,820,1.0,10,5.6
2025-08-18T12:19:19.692421,0,820,1.0,10,4.1
2025-08-18T12:19:20.192775,0,820,1.0,10,4.5
2025-08-18T12:19:20.693086,0,820,1.0,10,5.3
2025-08-18T12:19:21.193768,0,820,1.0,10,4.6
2025-08-18T12:19:21.694292,0,820,1.0,10,3.5
2025-08-18T12:19:22.194716,0,820,1.0,10,4.6
2025-08-18T12:19:22.695062,0,820,1.0,10,4.3
2025-08-18T12:19:23.195706,0,820,1.0,10,3.5
2025-08-18T12:19:23.696026,0,820,1.0,10,5.1
2025-08-18T12:19:24.196317,0,820,1.0,10,4.8
2025-08-18T12:19:24.696618,0,820,1.0,10,6.1
2025-08-18T12:19:25.196898,0,820,1.0,10,4.8
2025-08-18T12:19:25.697162,0,820,1.0,10,4.6
2025-08-18T12:19:26.197481,0,820,1.0,10,4.8
2025-08-18T12:19:26.697816,0,820,1.0,10,5.3
2025-08-18T12:19:27.198578,0,820,1.0,10,4.5
2025-08-18T12:19:27.698994,0,820,1.0,10,3.8
2025-08-18T12:19:28.199330,0,820,1.0,10,3.4
2025-08-18T12:19:28.699676,0,820,1.0,10,4.1
2025-08-18T12:19:29.200009,0,820,1.0,10,5.0
2025-08-18T12:19:29.700326,0,820,1.0,10,3.4
2025-08-18T12:19:30.201047,0,820,1.0,10,3.7
2025-08-18T12:19:30.701439,0,820,1.0,10,3.7
2025-08-18T12:19:31.201998,0,820,1.0,10,3.3
2025-08-18T12:19:31.702376,0,820,1.0,10,3.6
2025-08-18T12:19:32.202724,0,820,1.0,10,5.6
2025-08-18T12:19:32.703261,0,820,1.0,10,3.9
2025-08-18T12:19:33.203553,0,820,1.0,10,5.6
2025-08-18T12:19:33.703795,0,820,1.0,10,4.6
2025-08-18T12:19:34.204345,0,820,1.0,10,3.2
2025-08-18T12:19:34.704676,0,820,1.0,10,4.5
2025-08-18T12:19:35.204925,0,820,1.0,10,5.1
2025-08-18T12:19:35.705477,0,820,1.0,10,3.3
2025-08-18T12:19:36.206317,0,820,1.0,10,3.9
2025-08-18T12:19:36.706605,0,820,1.0,10,4.2
2025-08-18T12:19:37.207137,0,820,1.0,10,5.2
2025-08-18T12:19:37.707561,0,820,1.0,10,4.1
2025-08-18T12:19:38.207905,0,820,1.0,10,4.4
2025-08-18T12:19:38.708752,0,820,1.0,10,3.3
2025-08-18T12:19:39.209181,0,820,1.0,10,4.3
2025-08-18T12:19:39.709556,0,820,1.0,10,4.3
2025-08-18T12:19:40.210357,0,820,1.0,10,4.0
2025-08-18T12:19:40.710795,0,820,1.0,10,3.7
2025-08-18T12:19:41.211117,0,820,1.0,10,4.7
2025-08-18T12:19:41.711606,0,820,1.0,10,5.0
2025-08-18T12:19:42.211985,0,820,1.0,10,3.1
2025-08-18T12:19:42.712355,0,820,1.0,10,3.4
2025-08-18T12:19:43.212759,0,820,1.0,10,5.0
2025-08-18T12:19:43.713102,0,820,1.0,10,5.1
2025-08-18T12:19:44.213447,0,820,1.0,10,5.5
2025-08-18T12:19:44.713929,0,820,1.0,10,5.1
2025-08-18T12:19:45.214240,0,820,1.0,10,4.3
2025-08-18T12:19:45.714535,0,820,1.0,10,5.5
2025-08-18T12:19:46.215029,0,820,1.0,10,3.9
2025-08-18T12:19:46.715422,0,820,1.0,10,3.7
2025-08-18T12:19:47.215680,0,820,1.0,10,3.9
2025-08-18T12:19:47.716047,0,820,1.0,10,3.6
2025-08-18T12:19:48.216575,0,820,1.0,10,5.3
2025-08-18T12:19:48.716905,0,820,1.0,10,5.0
2025-08-18T12:19:49.217149,0,820,1.0,10,5.1
2025-08-18T12:19:49.717411,0,820,1.0,10,4.9
2025-08-18T12:19:50.217703,0,820,1.0,10,4.4
2025-08-18T12:19:50.718238,0,820,1.0,10,4.1
2025-08-18T12:19:51.218754,0,820,1.0,10,3.6
2025-08-18T12:19:51.719071,0,820,1.0,10,3.8
2025-08-18T12:19:52.219559,0,820,1.0,10,5.5
2025-08-18T12:19:52.719962,0,820,1.0,10,3.4
2025-08-18T12:19:53.220257,0,820,1.0,10,3.7
2025-08-18T12:19:53.720804,0,820,1.0,10,3.8
2025-08-18T12:19:54.221114,0,820,1.0,10,4.8
2025-08-18T12:19:54.721374,0,820,1.0,10,5.1
2025-08-18T12:19:55.221894,0,820,1.0,10,3.3
2025-08-18T12:19:55.722226,0,820,1.0,10,4.9
2025-08-18T12:19:56.222469,0,820,1.0,10,5.1
2025-08-18T12:19:56.722974,0,820,1.0,10,5.1
2025-08-18T12:19:57.223295,0,820,1.0,10,4.2
2025-08-18T12:19:57.723550,0,820,1.0,10,6.5
2025-08-18T12:19:58.223827,0,820,1.0,10,5.6
2025-08-18T12:19:58.724083,0,820,1.0,10,6.4
2025-08-18T12:19:59.224305,0,820,1.0,10,6.2
2025-08-18T12:19:59.724616,0,820,1.0,10,5.1
2025-08-18T12:20:00.224874,0,820,1.0,10,5.1
2025-08-18T12:20:00.725151,0,820,1.0,10,3.7
2025-08-18T12:20:01.225669,0,820,1.0,10,4.3
2025-08-18T12:20:01.725997,0,820,1.0,10,4.1
2025-08-18T12:20:02.226275,0,820,1.0,10,3.7
2025-08-18T12:20:02.726546,0,820,1.0,10,3.8
2025-08-18T12:20:03.226806,0,820,1.0,10,6.0
2025-08-18T12:20:03.727062,0,820,1.0,10,5.6
2025-08-18T12:20:04.227310,0,820,1.0,10,5.5
2025-08-18T12:20:04.727566,0,820,1.0,10,6.2
2025-08-18T12:20:05.227827,0,820,1.0,10,5.7
2025-08-18T12:20:05.728081,0,820,1.0,10,6.1
2025-08-18T12:20:06.228381,0,820,1.0,10,4.5
2025-08-18T12:20:06.728911,0,820,1.0,10,3.7
2025-08-18T12:20:07.229226,0,820,1.0,10,5.7
2025-08-18T12:20:07.729540,0,820,1.0,10,3.8
2025-08-18T12:20:08.230103,0,820,1.0,10,3.6
2025-08-18T12:20:08.730458,0,820,1.0,10,3.6
2025-08-18T12:20:09.230669,0,820,1.0,10,5.5
2025-08-18T12:20:09.731202,0,820,1.0,10,4.7
2025-08-18T12:20:10.231539,0,820,1.0,10,4.3
2025-08-18T12:20:10.731791,0,820,1.0,10,5.6
2025-08-18T12:20:11.232267,0,820,1.0,10,6.1
2025-08-18T12:20:11.732853,0,820,1.0,10,5.1
2025-08-18T12:20:12.233208,0,820,1.0,10,4.3
2025-08-18T12:20:12.733699,0,820,1.0,10,4.7
2025-08-18T12:20:13.233966,0,820,1.0,10,5.3
2025-08-18T12:20:13.734203,0,820,1.0,10,5.6
2025-08-18T12:20:14.234532,0,820,1.0,10,4.8
2025-08-18T12:20:14.734810,0,820,1.0,10,4.9
2025-08-18T12:20:15.235046,0,820,1.0,10,6.1
2025-08-18T12:20:15.735355,0,820,1.0,10,6.0
2025-08-18T12:20:16.235621,0,820,1.0,10,6.0
2025-08-18T12:20:16.735860,0,820,1.0,10,5.8
2025-08-18T12:20:17.236373,0,820,1.0,10,3.8
2025-08-18T12:20:17.736724,0,820,1.0,10,5.6
2025-08-18T12:20:18.236979,0,820,1.0,10,5.3
2025-08-18T12:20:18.737535,0,820,1.0,10,4.8
2025-08-18T12:20:19.237828,0,820,1.0,10,4.9
2025-08-18T12:20:19.738067,0,820,1.0,10,4.1
2025-08-18T12:20:20.238738,0,820,1.0,10,3.4
2025-08-18T12:20:20.739129,0,820,1.0,10,3.9
2025-08-18T12:20:21.239378,0,820,1.0,10,4.0
2025-08-18T12:20:21.739924,0,820,1.0,10,4.4
2025-08-18T12:20:22.240242,0,820,1.0,10,6.3
2025-08-18T12:20:22.740497,0,820,1.0,10,8.4
2025-08-18T12:20:23.241114,0,820,1.0,10,3.3
2025-08-18T12:20:23.741419,0,820,1.0,10,3.8
2025-08-18T12:20:24.241665,0,820,1.0,10,5.5
2025-08-18T12:20:24.742365,0,820,1.0,10,6.4
2025-08-18T12:20:25.242666,0,820,1.0,10,5.1
2025-08-18T12:20:25.742916,0,820,1.0,10,4.6
2025-08-18T12:20:26.243429,0,820,1.0,10,4.6
2025-08-18T12:20:26.743743,0,820,1.0,10,5.4
2025-08-18T12:20:27.244016,0,820,1.0,10,4.3
2025-08-18T12:20:27.744263,0,820,1.0,10,6.9
2025-08-18T12:20:28.244523,0,820,1.0,10,5.6
2025-08-18T12:20:28.744796,0,820,1.0,10,4.8
2025-08-18T12:20:29.245055,0,820,1.0,10,5.4
2025-08-18T12:20:29.745297,0,820,1.0,10,5.5
2025-08-18T12:20:30.245858,0,820,1.0,10,5.0
2025-08-18T12:20:30.746169,0,820,1.0,10,5.2
2025-08-18T12:20:31.246438,0,820,1.0,10,5.4
2025-08-18T12:20:31.746862,0,820,1.0,10,4.0
2025-08-18T12:20:32.247159,0,820,1.0,10,4.2
2025-08-18T12:20:32.747405,0,820,1.0,10,4.9
2025-08-18T12:20:33.247946,0,820,1.0,10,3.7
2025-08-18T12:20:33.748249,0,820,1.0,10,3.6
2025-08-18T12:20:34.248547,0,820,1.0,10,4.8
2025-08-18T12:20:34.748814,0,820,1.0,10,5.5
2025-08-18T12:20:35.249072,0,820,1.0,10,4.5
2025-08-18T12:20:35.749374,0,820,1.0,10,5.1
2025-08-18T12:20:36.249901,0,820,1.0,10,4.0
2025-08-18T12:20:36.750204,0,820,1.0,10,5.1
2025-08-18T12:20:37.250491,0,820,1.0,10,4.3
2025-08-18T12:20:37.750759,0,820,1.0,10,3.8
2025-08-18T12:20:38.251014,0,820,1.0,10,4.5
2025-08-18T12:20:38.751340,0,820,1.0,10,5.3
2025-08-18T12:20:39.251602,0,820,1.0,10,3.6
2025-08-18T12:20:39.751859,0,820,1.0,10,5.3
2025-08-18T12:20:40.252121,0,820,1.0,10,5.0
2025-08-18T12:20:40.752383,0,820,1.0,10,4.4
2025-08-18T12:20:41.252637,0,820,1.0,10,3.7
2025-08-18T12:20:41.753161,0,820,1.0,10,3.6
2025-08-18T12:20:42.253458,0,820,1.0,10,3.6
2025-08-18T12:20:42.753674,0,820,1.0,10,3.9
2025-08-18T12:20:43.254120,0,820,1.0,10,3.9
2025-08-18T12:20:43.754400,0,820,1.0,10,3.6
2025-08-18T12:20:44.254648,0,820,1.0,10,3.9
2025-08-18T12:20:44.755144,0,820,1.0,10,3.9
2025-08-18T12:20:45.255448,0,820,1.0,10,4.3
2025-08-18T12:20:45.755681,0,820,1.0,10,5.2
2025-08-18T12:20:46.256164,0,820,1.0,10,4.7
2025-08-18T12:20:46.756472,0,820,1.0,10,5.2
2025-08-18T12:20:47.256723,0,820,1.0,10,5.1
2025-08-18T12:20:47.757107,0,820,1.0,10,4.0
2025-08-18T12:20:48.257380,0,820,1.0,10,6.6
2025-08-18T12:20:48.757627,0,820,1.0,10,5.7
2025-08-18T12:20:49.258168,0,820,1.0,10,4.8
2025-08-18T12:20:49.758476,0,820,1.0,10,5.1
2025-08-18T12:20:50.258816,0,820,1.0,10,3.6
2025-08-18T12:20:50.759307,0,820,1.0,10,3.7
2025-08-18T12:20:51.259629,0,820,1.0,10,3.9
2025-08-18T12:20:51.759934,0,820,1.0,10,3.7
2025-08-18T12:20:52.260441,0,820,1.0,10,3.3
2025-08-18T12:20:52.760756,0,820,1.0,10,4.0
2025-08-18T12:20:53.261071,0,820,1.0,10,5.3
2025-08-18T12:20:53.761428,0,820,1.0,10,4.3
2025-08-18T12:20:54.261661,0,820,1.0,10,5.5
2025-08-18T12:20:54.761907,0,820,1.0,10,3.4
2025-08-18T12:20:55.262476,0,820,1.0,10,3.1
2025-08-18T12:20:55.762809,0,820,1.0,10,4.3
2025-08-18T12:20:56.263123,0,820,1.0,10,3.5
2025-08-18T12:20:56.763451,0,820,1.0,10,3.6
2025-08-18T12:20:57.263676,0,820,1.0,10,5.3
2025-08-18T12:20:57.763930,0,820,1.0,10,4.5
2025-08-18T12:20:58.264239,0,820,1.0,10,4.7
2025-08-18T12:20:58.764499,0,820,1.0,10,4.6
2025-08-18T12:20:59.264748,0,820,1.0,10,5.1
2025-08-18T12:20:59.765001,0,820,1.0,10,4.3
2025-08-18T12:21:00.265232,0,820,1.0,10,4.7
2025-08-18T12:21:00.765474,0,820,1.0,10,3.9
2025-08-18T12:21:01.265731,0,820,1.0,10,4.5
2025-08-18T12:21:01.765971,0,820,1.0,10,3.6
2025-08-18T12:21:02.266387,0,820,1.0,10,3.9
2025-08-18T12:21:02.766936,0,820,1.0,10,4.2
2025-08-18T12:21:03.267240,0,820,1.0,10,4.1
2025-08-18T12:21:03.767486,0,820,1.0,10,4.8
2025-08-18T12:21:04.267734,0,820,1.0,10,5.2
2025-08-18T12:21:04.767978,0,820,1.0,10,4.4
2025-08-18T12:21:05.268243,0,820,1.0,10,4.7
2025-08-18T12:21:05.768773,0,820,1.0,10,3.6
2025-08-18T12:21:06.269071,0,820,1.0,10,3.8
2025-08-18T12:21:06.769346,0,820,1.0,10,5.5
2025-08-18T12:21:07.269593,0,820,1.0,10,3.3
2025-08-18T12:21:07.769836,0,820,1.0,10,3.7
2025-08-18T12:21:08.270314,0,820,1.0,10,3.4
2025-08-18T12:21:08.770668,0,820,1.0,10,3.3
2025-08-18T12:21:09.270918,0,820,1.0,10,4.1
2025-08-18T12:21:09.771414,0,820,1.0,10,3.5
2025-08-18T12:21:10.271664,0,820,1.0,10,3.4
2025-08-18T12:21:10.771915,0,820,1.0,10,4.1
2025-08-18T12:21:11.272448,0,820,1.0,10,2.9
2025-08-18T12:21:11.772761,0,820,1.0,10,4.1
2025-08-18T12:21:12.273073,0,820,1.0,10,5.0
2025-08-18T12:21:12.773579,0,820,1.0,10,3.6
2025-08-18T12:21:13.273906,0,820,1.0,10,3.7
2025-08-18T12:21:13.774150,0,820,1.0,10,3.8
2025-08-18T12:21:14.274764,0,820,1.0,10,3.3
2025-08-18T12:21:14.775070,0,820,1.0,10,5.0
2025-08-18T12:21:15.275279,0,820,1.0,10,5.3
2025-08-18T12:21:15.775798,0,820,1.0,10,3.8
2025-08-18T12:21:16.276139,0,820,1.0,10,5.7
2025-08-18T12:21:16.776382,0,820,1.0,10,5.4
2025-08-18T12:21:17.276870,0,820,1.0,10,3.3
2025-08-18T12:21:17.777170,0,820,1.0,10,4.5
2025-08-18T12:21:18.277420,0,820,1.0,10,4.9
2025-08-18T12:21:18.777927,0,820,1.0,10,4.1
2025-08-18T12:21:19.278237,0,820,1.0,10,3.5
2025-08-18T12:21:19.778595,0,820,1.0,10,3.6
2025-08-18T12:21:20.278834,0,820,1.0,10,2.8
2025-08-18T12:21:20.779095,0,820,1.0,10,3.6
2025-08-18T12:21:21.279453,0,820,1.0,10,3.5
2025-08-18T12:21:21.779790,0,820,1.0,10,4.8
2025-08-18T12:21:22.280082,0,820,1.0,10,4.1
2025-08-18T12:21:22.780362,0,820,1.0,10,3.9
2025-08-18T12:21:23.280913,0,820,1.0,10,3.8
2025-08-18T12:21:23.781217,0,820,1.0,10,3.2
2025-08-18T12:21:24.281466,0,820,1.0,10,4.8
2025-08-18T12:21:24.781675,0,820,1.0,10,3.5
2025-08-18T12:21:25.281929,0,820,1.0,10,3.6
2025-08-18T12:21:25.782215,0,820,1.0,10,4.9
2025-08-18T12:21:26.282474,0,820,1.0,10,3.3
2025-08-18T12:21:26.782961,0,820,1.0,10,3.1
2025-08-18T12:21:27.283279,0,820,1.0,10,3.3
2025-08-18T12:21:27.783620,0,820,1.0,10,5.0
2025-08-18T12:21:28.284102,0,820,1.0,10,2.7
2025-08-18T12:21:28.784402,0,820,1.0,10,3.7
2025-08-18T12:21:29.284738,0,820,1.0,10,3.3
2025-08-18T12:21:29.784976,0,820,1.0,10,3.1
2025-08-18T12:21:30.285229,0,820,1.0,10,3.1
2025-08-18T12:21:30.785775,0,820,1.0,10,3.4
2025-08-18T12:21:31.286095,0,820,1.0,10,3.2
2025-08-18T12:21:31.786360,0,820,1.0,10,3.5
2025-08-18T12:21:32.286945,0,820,1.0,10,3.1
2025-08-18T12:21:32.787251,0,820,1.0,10,3.1
2025-08-18T12:21:33.287515,0,820,1.0,10,3.4
2025-08-18T12:21:33.787764,0,820,1.0,10,3.0
2025-08-18T12:21:34.288038,0,820,1.0,10,3.3
2025-08-18T12:21:34.788555,0,820,1.0,10,2.9
2025-08-18T12:21:35.288854,0,820,1.0,10,3.2
2025-08-18T12:21:35.789100,0,820,1.0,10,3.6
2025-08-18T12:21:36.289742,0,820,1.0,10,2.9
2025-08-18T12:21:36.790053,0,820,1.0,10,3.4
2025-08-18T12:21:37.290342,0,820,1.0,10,3.2
2025-08-18T12:21:37.790620,0,820,1.0,10,3.0
2025-08-18T12:21:38.290885,0,820,1.0,10,3.3
2025-08-18T12:21:38.791385,0,820,1.0,10,3.0
2025-08-18T12:21:39.291689,0,820,1.0,10,3.6
2025-08-18T12:21:39.791943,0,820,1.0,10,3.5
2025-08-18T12:21:40.292466,0,820,1.0,10,2.9
2025-08-18T12:21:40.792903,0,820,1.0,10,3.8
2025-08-18T12:21:41.293167,0,820,1.0,10,3.3
2025-08-18T12:21:41.793450,0,820,1.0,10,4.3
2025-08-18T12:21:42.293692,0,820,1.0,10,5.8
2025-08-18T12:21:42.793999,0,820,1.0,10,3.7
2025-08-18T12:21:43.294295,0,820,1.0,10,4.4
2025-08-18T12:21:43.794563,0,820,1.0,10,4.0
2025-08-18T12:21:44.295169,0,820,1.0,10,3.6
2025-08-18T12:21:44.795583,0,820,1.0,10,3.9
2025-08-18T12:21:45.295838,0,820,1.0,10,3.9
2025-08-18T12:21:45.796148,0,820,1.0,10,7.6
2025-08-18T12:21:46.296687,0,820,1.0,10,3.8
2025-08-18T12:21:46.796986,0,820,1.0,10,5.4
2025-08-18T12:21:47.297315,0,820,1.0,10,4.1
2025-08-18T12:21:47.797587,0,820,1.0,10,4.1
2025-08-18T12:21:48.297827,0,820,1.0,10,3.3
2025-08-18T12:21:48.798164,0,820,1.0,10,5.1
2025-08-18T12:21:49.298431,0,820,1.0,10,3.9
2025-08-18T12:21:49.798669,0,820,1.0,10,4.5
2025-08-18T12:21:50.299226,0,820,1.0,10,3.4
2025-08-18T12:21:50.799566,0,820,1.0,10,4.8
2025-08-18T12:21:51.299841,0,820,1.0,10,4.1
2025-08-18T12:21:51.800382,0,820,1.0,10,3.5
2025-08-18T12:21:52.300672,0,820,1.0,10,4.8
2025-08-18T12:21:52.800937,0,820,1.0,10,3.9
2025-08-18T12:21:53.301651,0,820,1.0,10,2.8
2025-08-18T12:21:53.801974,0,820,1.0,10,4.1
2025-08-18T12:21:54.302229,0,820,1.0,10,4.4
2025-08-18T12:21:54.802781,0,820,1.0,10,3.9
2025-08-18T12:21:55.303091,0,820,1.0,10,3.6
2025-08-18T12:21:55.803533,0,820,1.0,10,5.1
2025-08-18T12:21:56.304135,0,820,1.0,10,3.9
2025-08-18T12:21:56.804462,0,820,1.0,10,3.6
2025-08-18T12:21:57.304677,0,820,1.0,10,4.2
2025-08-18T12:21:57.804908,0,820,1.0,10,4.6
2025-08-18T12:21:58.305226,0,820,1.0,10,3.3
2025-08-18T12:21:58.805749,0,820,1.0,10,3.3
2025-08-18T12:21:59.306093,0,820,1.0,10,3.6
2025-08-18T12:21:59.806350,0,820,1.0,10,3.4
2025-08-18T12:22:00.306698,0,820,1.0,10,3.4
2025-08-18T12:22:00.806953,0,820,1.0,10,5.6
2025-08-18T12:22:01.307221,0,820,1.0,10,5.2
2025-08-18T12:22:01.807497,0,820,1.0,10,3.4
2025-08-18T12:22:02.307817,0,820,1.0,10,4.1
2025-08-18T12:22:02.808071,0,820,1.0,10,3.9
2025-08-18T12:22:03.308336,0,820,1.0,10,6.2
2025-08-18T12:22:03.808587,0,820,1.0,10,4.8
2025-08-18T12:22:04.308838,0,820,1.0,10,4.1
2025-08-18T12:22:04.809184,0,820,1.0,10,3.4
2025-08-18T12:22:05.309447,0,820,1.0,10,4.3
2025-08-18T12:22:05.810009,0,820,1.0,10,4.8
2025-08-18T12:22:06.310353,0,820,1.0,10,3.4
2025-08-18T12:22:06.810600,0,820,1.0,10,4.4
2025-08-18T12:22:07.310921,0,820,1.0,10,5.2
2025-08-18T12:22:07.811175,0,820,1.0,10,5.1
2025-08-18T12:22:08.311420,0,820,1.0,10,5.3
2025-08-18T12:22:08.811947,0,820,1.0,10,4.5
2025-08-18T12:22:09.312247,0,820,1.0,10,5.0
2025-08-18T12:22:09.812491,0,820,1.0,10,4.8
2025-08-18T12:22:10.312736,0,820,1.0,10,4.3
2025-08-18T12:22:10.812957,0,820,1.0,10,4.8
2025-08-18T12:22:11.313236,0,820,1.0,10,4.2
2025-08-18T12:22:11.813470,0,820,1.0,10,4.1
2025-08-18T12:22:12.313725,0,820,1.0,10,4.1
2025-08-18T12:22:12.814224,0,820,1.0,10,3.8
2025-08-18T12:22:13.314539,0,820,1.0,10,3.6
2025-08-18T12:22:13.814788,0,820,1.0,10,3.8
2025-08-18T12:22:14.315278,0,820,1.0,10,3.4
2025-08-18T12:22:14.815596,0,820,1.0,10,5.1
2025-08-18T12:22:15.315836,0,820,1.0,10,4.3
2025-08-18T12:22:15.816551,0,820,1.0,10,3.3
2025-08-18T12:22:16.316897,0,820,1.0,10,5.4
2025-08-18T12:22:16.817158,0,820,1.0,10,4.5
2025-08-18T12:22:17.317696,0,820,1.0,10,4.3
2025-08-18T12:22:17.818012,0,820,1.0,10,3.6
2025-08-18T12:22:18.318299,0,820,1.0,10,3.8
2025-08-18T12:22:18.818575,0,820,1.0,10,3.1
2025-08-18T12:22:19.318833,0,820,1.0,10,4.0
2025-08-18T12:22:19.819081,0,820,1.0,10,6.2
2025-08-18T12:22:20.319403,0,820,1.0,10,7.3
2025-08-18T12:22:20.819671,0,820,1.0,10,5.3
2025-08-18T12:22:21.319979,0,820,1.0,10,4.1
2025-08-18T12:22:21.820493,0,820,1.0,10,4.8
2025-08-18T12:22:22.320812,0,820,1.0,10,5.2
2025-08-18T12:22:22.821062,0,820,1.0,10,4.1
2025-08-18T12:22:23.321582,0,820,1.0,10,6.4
2025-08-18T12:22:23.821906,0,820,1.0,10,6.4
2025-08-18T12:22:24.322156,0,820,1.0,10,6.0
2025-08-18T12:22:24.822679,0,820,1.0,10,6.4
2025-08-18T12:22:25.322977,0,820,1.0,10,5.0
2025-08-18T12:22:25.823221,0,820,1.0,10,5.8
2025-08-18T12:22:26.323595,0,820,1.0,10,5.7
2025-08-18T12:22:26.823876,0,820,1.0,10,4.0
2025-08-18T12:22:27.324132,0,820,1.0,10,4.6
2025-08-18T12:22:27.824381,0,820,1.0,10,4.1
2025-08-18T12:22:28.324630,0,820,1.0,10,7.1
2025-08-18T12:22:28.824881,0,820,1.0,10,5.7
2025-08-18T12:22:29.325244,0,820,1.0,10,6.7
2025-08-18T12:22:29.825543,0,820,1.0,10,6.9
2025-08-18T12:22:30.325790,0,820,1.0,10,4.9
2025-08-18T12:22:30.826157,0,820,1.0,10,3.7
2025-08-18T12:22:31.326518,0,820,1.0,10,3.6
2025-08-18T12:22:31.826774,0,820,1.0,10,4.6
2025-08-18T12:22:32.327042,0,820,1.0,10,5.5
2025-08-18T12:22:32.827567,0,820,1.0,10,3.3
2025-08-18T12:22:33.327864,0,820,1.0,10,3.5
2025-08-18T12:22:33.828201,0,820,1.0,10,3.5
2025-08-18T12:22:34.328465,0,820,1.0,10,3.1
2025-08-18T12:22:34.828669,0,820,1.0,10,4.1
2025-08-18T12:22:35.329076,0,820,1.0,10,3.3
2025-08-18T12:22:35.829360,0,820,1.0,10,3.4
2025-08-18T12:22:36.329601,0,820,1.0,10,3.7
2025-08-18T12:22:36.829945,0,820,1.0,10,4.0
2025-08-18T12:22:37.330198,0,820,1.0,10,3.3
2025-08-18T12:22:37.830436,0,820,1.0,10,4.3
2025-08-18T12:22:38.330707,0,820,1.0,10,5.7
2025-08-18T12:22:38.830971,0,820,1.0,10,6.3
2025-08-18T12:22:39.331208,0,820,1.0,10,4.9
2025-08-18T12:22:39.831521,0,820,1.0,10,4.8
2025-08-18T12:22:40.331818,0,820,1.0,10,5.5
2025-08-18T12:22:40.832053,0,820,1.0,10,3.6
2025-08-18T12:22:41.332555,0,820,1.0,10,4.3
2025-08-18T12:22:41.832868,0,820,1.0,10,4.7
2025-08-18T12:22:42.333084,0,820,1.0,10,3.4
2025-08-18T12:22:42.833743,0,820,1.0,10,3.2
2025-08-18T12:22:43.334081,0,820,1.0,10,3.6
2025-08-18T12:22:43.834308,0,820,1.0,10,3.5
2025-08-18T12:22:44.334930,0,820,1.0,10,3.3
2025-08-18T12:22:44.835236,0,820,1.0,10,3.8
2025-08-18T12:22:45.335464,0,820,1.0,10,4.0
2025-08-18T12:22:45.836115,0,820,1.0,10,3.5
2025-08-18T12:22:46.336451,0,820,1.0,10,3.8
2025-08-18T12:22:46.836674,0,820,1.0,10,3.8
2025-08-18T12:22:47.337185,0,820,1.0,10,3.0
2025-08-18T12:22:47.837489,0,820,1.0,10,3.5
2025-08-18T12:22:48.337730,0,820,1.0,10,3.8
2025-08-18T12:22:48.837977,0,820,1.0,10,3.4
2025-08-18T12:22:49.338209,0,820,1.0,10,4.0
2025-08-18T12:22:49.838832,0,820,1.0,10,3.4
2025-08-18T12:22:50.339171,0,820,1.0,10,3.9
2025-08-18T12:22:50.839476,0,820,1.0,10,3.8
2025-08-18T12:22:51.339995,0,820,1.0,10,3.2
2025-08-18T12:22:51.840263,0,820,1.0,10,3.3
2025-08-18T12:22:52.340504,0,820,1.0,10,3.5
2025-08-18T12:22:52.841044,0,820,1.0,10,3.3
2025-08-18T12:22:53.341365,0,820,1.0,10,5.5
2025-08-18T12:22:53.841618,0,820,1.0,10,3.9
2025-08-18T12:22:54.342131,0,820,1.0,10,3.9
2025-08-18T12:22:54.842437,0,820,1.0,10,4.7
2025-08-18T12:22:55.342646,0,820,1.0,10,4.6
2025-08-18T12:22:55.843167,0,820,1.0,10,5.3
2025-08-18T12:22:56.343469,0,820,1.0,10,4.1
2025-08-18T12:22:56.843666,0,820,1.0,10,4.2
2025-08-18T12:22:57.344191,0,820,1.0,10,4.0
2025-08-18T12:22:57.844512,0,820,1.0,10,6.4
2025-08-18T12:22:58.344756,0,820,1.0,10,5.6
2025-08-18T12:22:58.845000,0,820,1.0,10,4.5
2025-08-18T12:22:59.345239,0,820,1.0,10,4.8
2025-08-18T12:22:59.845471,0,820,1.0,10,4.6
2025-08-18T12:23:00.345665,0,820,1.0,10,4.4
2025-08-18T12:23:00.845914,0,820,1.0,10,4.6
2025-08-18T12:23:01.346160,0,820,1.0,10,5.3
2025-08-18T12:23:01.846434,0,820,1.0,10,4.3
2025-08-18T12:23:02.346679,0,820,1.0,10,3.4
2025-08-18T12:23:02.846919,0,820,1.0,10,4.8
2025-08-18T12:23:03.347439,0,820,1.0,10,4.4
2025-08-18T12:23:03.847762,0,820,1.0,10,4.1
2025-08-18T12:23:04.347997,0,820,1.0,10,4.5
2025-08-18T12:23:04.848498,0,820,1.0,10,4.6
2025-08-18T12:23:05.348822,0,820,1.0,10,4.2
2025-08-18T12:23:05.849057,0,820,1.0,10,3.9
2025-08-18T12:23:06.349336,0,820,1.0,10,3.4
2025-08-18T12:23:06.849581,0,820,1.0,10,5.0
2025-08-18T12:23:07.349834,0,820,1.0,10,5.6
2025-08-18T12:23:07.850085,0,820,1.0,10,3.6
2025-08-18T12:23:08.350376,0,820,1.0,10,3.9
2025-08-18T12:23:08.850783,0,820,1.0,10,3.8
2025-08-18T12:23:09.351054,0,820,1.0,10,5.2
2025-08-18T12:23:09.851286,0,820,1.0,10,6.0
2025-08-18T12:23:10.351531,0,820,1.0,10,5.5
2025-08-18T12:23:10.851873,0,820,1.0,10,5.1
2025-08-18T12:23:11.352211,0,820,1.0,10,4.2
2025-08-18T12:23:11.853014,0,820,1.0,10,3.5
2025-08-18T12:23:12.353482,0,820,1.0,10,4.1
2025-08-18T12:23:12.853858,0,820,1.0,10,3.7
2025-08-18T12:23:13.354166,0,820,1.0,10,4.1
2025-08-18T12:23:13.854461,0,820,1.0,10,4.3
2025-08-18T12:23:14.354807,0,820,1.0,10,5.1
2025-08-18T12:23:14.855054,0,820,1.0,10,4.5
2025-08-18T12:23:15.355293,0,820,1.0,10,3.6
2025-08-18T12:23:15.855732,0,820,1.0,10,3.8
2025-08-18T12:23:16.356023,0,820,1.0,10,3.6
2025-08-18T12:23:16.856255,0,820,1.0,10,4.3
2025-08-18T12:23:17.356900,0,820,1.0,10,4.3
2025-08-18T12:23:17.857247,0,820,1.0,10,3.4
2025-08-18T12:23:18.357538,0,820,1.0,10,4.8
2025-08-18T12:23:18.858050,0,820,1.0,10,3.6
2025-08-18T12:23:19.358395,0,820,1.0,10,6.2
2025-08-18T12:23:19.858706,0,820,1.0,10,4.3
2025-08-18T12:23:20.358939,0,820,1.0,10,4.6
2025-08-18T12:23:20.859174,0,820,1.0,10,6.9
2025-08-18T12:23:21.359399,0,820,1.0,10,3.8
2025-08-18T12:23:21.859930,0,820,1.0,10,3.3
2025-08-18T12:23:22.360312,0,820,1.0,10,3.7
2025-08-18T12:23:22.860575,0,820,1.0,10,5.6
2025-08-18T12:23:23.360945,0,820,1.0,10,4.5
2025-08-18T12:23:23.861243,0,820,1.0,10,4.4
2025-08-18T12:23:24.361538,0,820,1.0,10,5.3
2025-08-18T12:23:24.861807,0,820,1.0,10,3.3
2025-08-18T12:23:25.362050,0,820,1.0,10,3.9
2025-08-18T12:23:25.862628,0,820,1.0,10,3.3
2025-08-18T12:23:26.362941,0,820,1.0,10,3.8
2025-08-18T12:23:26.863217,0,820,1.0,10,4.2
2025-08-18T12:23:27.363852,0,820,1.0,10,3.6
2025-08-18T12:23:27.864203,0,820,1.0,10,3.6
2025-08-18T12:23:28.364452,0,820,1.0,10,4.7
2025-08-18T12:23:28.864942,0,820,1.0,10,4.2
2025-08-18T12:23:29.365265,0,820,1.0,10,3.9
2025-08-18T12:23:29.865499,0,820,1.0,10,3.4
2025-08-18T12:23:30.366004,0,820,1.0,10,3.1
2025-08-18T12:23:30.866290,0,820,1.0,10,3.5
2025-08-18T12:23:31.366569,0,820,1.0,10,3.6
2025-08-18T12:23:31.866844,0,820,1.0,10,5.7
2025-08-18T12:23:32.367091,0,820,1.0,10,4.9
2025-08-18T12:23:32.867344,0,820,1.0,10,4.5
2025-08-18T12:23:33.367600,0,820,1.0,10,5.2
2025-08-18T12:23:33.867883,0,820,1.0,10,5.1
2025-08-18T12:23:34.368196,0,820,1.0,10,4.8
2025-08-18T12:23:34.868514,0,820,1.0,10,4.8
2025-08-18T12:23:35.368754,0,820,1.0,10,4.4
2025-08-18T12:23:35.869085,0,820,1.0,10,4.1
2025-08-18T12:23:36.369410,0,820,1.0,10,5.0
2025-08-18T12:23:36.869671,0,820,1.0,10,4.3
2025-08-18T12:23:37.370267,0,820,1.0,10,3.1
2025-08-18T12:23:37.870652,0,820,1.0,10,3.5
2025-08-18T12:23:38.370903,0,820,1.0,10,5.5
2025-08-18T12:23:38.871443,0,820,1.0,10,3.1
2025-08-18T12:23:39.371783,0,820,1.0,10,4.2
2025-08-18T12:23:39.872014,0,820,1.0,10,3.4
2025-08-18T12:23:40.372272,0,820,1.0,10,5.1
2025-08-18T12:23:40.872532,0,820,1.0,10,4.9
2025-08-18T12:23:41.372799,0,820,1.0,10,5.4
2025-08-18T12:23:41.873176,0,820,1.0,10,3.9
2025-08-18T12:23:42.373422,0,820,1.0,10,4.6
2025-08-18T12:23:42.873659,0,820,1.0,10,4.9
2025-08-18T12:23:43.374157,0,820,1.0,10,3.4
2025-08-18T12:23:43.874516,0,820,1.0,10,3.5
2025-08-18T12:23:44.374821,0,820,1.0,10,4.1
2025-08-18T12:23:44.875343,0,820,1.0,10,5.2
2025-08-18T12:23:45.375647,0,820,1.0,10,4.0
2025-08-18T12:23:45.875886,0,820,1.0,10,4.6
2025-08-18T12:23:46.376418,0,820,1.0,10,4.5
2025-08-18T12:23:46.876751,0,820,1.0,10,4.4
2025-08-18T12:23:47.376985,0,820,1.0,10,4.3
2025-08-18T12:23:47.877232,0,820,1.0,10,4.5
2025-08-18T12:23:48.377472,0,820,1.0,10,3.9
2025-08-18T12:23:48.877794,0,820,1.0,10,5.5
2025-08-18T12:23:49.378376,0,820,1.0,10,4.7
2025-08-18T12:23:49.878675,0,820,1.0,10,4.3
2025-08-18T12:23:50.378918,0,820,1.0,10,4.3
2025-08-18T12:23:50.879436,0,820,1.0,10,3.5
2025-08-18T12:23:51.379718,0,820,1.0,10,4.0
2025-08-18T12:23:51.879977,0,820,1.0,10,4.7
2025-08-18T12:23:52.380456,0,820,1.0,10,4.1
2025-08-18T12:23:52.880780,0,820,1.0,10,3.3
2025-08-18T12:23:53.381054,0,820,1.0,10,4.3
2025-08-18T12:23:53.881577,0,820,1.0,10,3.6
2025-08-18T12:23:54.381889,0,820,1.0,10,3.6
2025-08-18T12:23:54.882138,0,820,1.0,10,5.4
2025-08-18T12:23:55.382576,0,820,1.0,10,4.0
2025-08-18T12:23:55.882923,0,820,1.0,10,4.3
2025-08-18T12:23:56.383243,0,820,1.0,10,4.7
2025-08-18T12:23:56.883795,0,820,1.0,10,4.3
2025-08-18T12:23:57.384128,0,820,1.0,10,5.5
2025-08-18T12:23:57.884417,0,820,1.0,10,5.0
2025-08-18T12:23:58.384669,0,820,1.0,10,5.0
2025-08-18T12:23:58.884910,0,820,1.0,10,5.3
2025-08-18T12:23:59.385176,0,820,1.0,10,5.5
2025-08-18T12:23:59.885502,0,820,1.0,10,4.9
2025-08-18T12:24:00.385751,0,820,1.0,10,5.2
2025-08-18T12:24:00.886225,0,820,1.0,10,3.8
2025-08-18T12:24:01.386505,0,820,1.0,10,3.6
2025-08-18T12:24:01.886758,0,820,1.0,10,3.8
2025-08-18T12:24:02.387379,0,820,1.0,10,3.3
2025-08-18T12:24:02.887668,0,820,1.0,10,5.3
2025-08-18T12:24:03.387994,0,820,1.0,10,4.7
2025-08-18T12:24:03.888720,0,820,1.0,10,3.8
2025-08-18T12:24:04.389115,0,820,1.0,10,4.8
2025-08-18T12:24:04.889403,0,820,1.0,10,4.5
2025-08-18T12:24:05.389808,0,820,1.0,10,4.8
2025-08-18T12:24:05.890071,0,820,1.0,10,4.2
2025-08-18T12:24:06.390340,0,820,1.0,10,3.8
2025-08-18T12:24:06.890938,0,820,1.0,10,3.6
2025-08-18T12:24:07.391277,0,820,1.0,10,3.5
2025-08-18T12:24:07.891533,0,820,1.0,10,3.6
2025-08-18T12:24:08.392123,0,820,1.0,10,3.6
2025-08-18T12:24:08.892429,0,820,1.0,10,3.9
2025-08-18T12:24:09.392713,0,820,1.0,10,3.9
2025-08-18T12:24:09.893350,0,820,1.0,10,3.8
2025-08-18T12:24:10.393663,0,820,1.0,10,5.3
2025-08-18T12:24:10.893908,0,820,1.0,10,4.7
2025-08-18T12:24:11.394245,0,820,1.0,10,3.7
2025-08-18T12:24:11.894576,0,820,1.0,10,3.3
2025-08-18T12:24:12.394895,0,820,1.0,10,3.6
2025-08-18T12:24:12.895417,0,820,1.0,10,3.3
2025-08-18T12:24:13.395750,0,820,1.0,10,3.5
2025-08-18T12:24:13.895998,0,820,1.0,10,3.4
2025-08-18T12:24:14.396488,0,820,1.0,10,3.1
2025-08-18T12:24:14.896860,0,820,1.0,10,3.4
2025-08-18T12:24:15.397169,0,820,1.0,10,3.6
2025-08-18T12:24:15.897695,0,820,1.0,10,3.2
2025-08-18T12:24:16.397997,0,820,1.0,10,3.5
2025-08-18T12:24:16.898260,0,820,1.0,10,3.4
2025-08-18T12:24:17.398642,0,820,1.0,10,3.0
2025-08-18T12:24:17.898899,0,820,1.0,10,3.4
2025-08-18T12:24:18.399165,0,820,1.0,10,3.4
2025-08-18T12:24:18.899665,0,820,1.0,10,3.2
2025-08-18T12:24:19.399997,0,820,1.0,10,3.8
2025-08-18T12:24:19.900326,0,820,1.0,10,3.5
2025-08-18T12:24:20.400854,0,820,1.0,10,2.9
2025-08-18T12:24:20.901161,0,820,1.0,10,3.5
2025-08-18T12:24:21.401406,0,820,1.0,10,3.4
2025-08-18T12:24:21.901662,0,820,1.0,10,3.0
2025-08-18T12:24:22.401922,0,820,1.0,10,3.4
2025-08-18T12:24:22.902178,0,820,1.0,10,3.5
2025-08-18T12:24:23.402489,0,820,1.0,10,2.9
2025-08-18T12:24:23.902834,0,820,1.0,10,3.6
2025-08-18T12:24:24.403233,0,820,1.0,10,3.4
2025-08-18T12:24:24.903524,0,820,1.0,10,3.1
2025-08-18T12:24:25.403764,0,820,1.0,10,3.4
2025-08-18T12:24:25.904276,0,820,1.0,10,3.2
2025-08-18T12:24:26.404584,0,820,1.0,10,3.3
2025-08-18T12:24:26.904872,0,820,1.0,10,3.4
2025-08-18T12:24:27.405390,0,820,1.0,10,2.8
2025-08-18T12:24:27.905675,0,820,1.0,10,3.4
2025-08-18T12:24:28.405955,0,820,1.0,10,3.4
2025-08-18T12:24:28.906216,0,820,1.0,10,3.0
2025-08-18T12:24:29.406462,0,820,1.0,10,3.7
2025-08-18T12:24:29.906783,0,820,1.0,10,3.2
2025-08-18T12:24:30.407136,0,820,1.0,10,3.2
2025-08-18T12:24:30.907456,0,820,1.0,10,3.7
2025-08-18T12:24:31.408108,0,820,1.0,10,2.9
2025-08-18T12:24:31.908478,0,820,1.0,10,3.4
2025-08-18T12:24:32.408784,0,820,1.0,10,3.5
2025-08-18T12:24:32.909459,0,820,1.0,10,3.1
2025-08-18T12:24:33.409822,0,820,1.0,10,3.3
2025-08-18T12:24:33.910076,0,820,1.0,10,3.3
2025-08-18T12:24:34.410643,0,820,1.0,10,2.9
2025-08-18T12:24:34.910976,0,820,1.0,10,3.5
2025-08-18T12:24:35.411385,0,820,1.0,10,3.4
2025-08-18T12:24:35.911692,0,820,1.0,10,3.5
2025-08-18T12:24:36.411988,0,820,1.0,10,3.4
2025-08-18T12:24:36.912703,0,820,1.0,10,3.2
2025-08-18T12:24:37.413057,0,820,1.0,10,3.3
2025-08-18T12:24:37.913348,0,820,1.0,10,3.6
2025-08-18T12:24:38.414286,0,820,1.0,10,2.9
2025-08-18T12:24:38.914706,0,820,1.0,10,3.4
2025-08-18T12:24:39.415036,0,820,1.0,10,3.6
2025-08-18T12:24:39.915895,0,820,1.0,10,3.1
2025-08-18T12:24:40.416282,0,820,1.0,10,3.5
2025-08-18T12:24:40.916619,0,820,1.0,10,3.5
2025-08-18T12:24:41.417386,0,820,1.0,10,2.9
2025-08-18T12:24:41.917824,0,820,1.0,10,3.8
2025-08-18T12:24:42.418127,0,820,1.0,10,3.3
2025-08-18T12:24:42.918924,0,820,1.0,10,3.3
2025-08-18T12:24:43.419352,0,820,1.0,10,3.4
2025-08-18T12:24:43.919699,0,820,1.0,10,3.3
2025-08-18T12:24:44.420223,0,820,1.0,10,3.0
2025-08-18T12:24:44.920523,0,820,1.0,10,3.6
2025-08-18T12:24:45.420764,0,820,1.0,10,3.8
2025-08-18T12:24:45.921016,0,820,1.0,10,3.3
2025-08-18T12:24:46.421265,0,820,1.0,10,3.4
2025-08-18T12:24:46.921769,0,820,1.0,10,3.2
2025-08-18T12:24:47.422099,0,820,1.0,10,3.4
2025-08-18T12:24:47.922343,0,820,1.0,10,3.7
2025-08-18T12:24:48.422730,0,820,1.0,10,3.3
2025-08-18T12:24:48.923053,0,820,1.0,10,3.3
2025-08-18T12:24:49.423316,0,820,1.0,10,3.6
2025-08-18T12:24:49.923577,0,820,1.0,10,3.6
2025-08-18T12:24:50.423871,0,820,1.0,10,2.9
2025-08-18T12:24:50.924113,0,820,1.0,10,3.5
2025-08-18T12:24:51.424353,0,820,1.0,10,4.6
2025-08-18T12:24:51.924643,0,820,1.0,10,2.9
2025-08-18T12:24:52.424901,0,820,1.0,10,3.3
2025-08-18T12:24:52.925154,0,820,1.0,10,3.4
2025-08-18T12:24:53.425403,0,820,1.0,10,3.1
2025-08-18T12:24:53.925652,0,820,1.0,10,3.6
2025-08-18T12:24:54.425993,0,820,1.0,10,3.4
2025-08-18T12:24:54.926296,0,820,1.0,10,3.1
2025-08-18T12:24:55.426551,0,820,1.0,10,3.4
2025-08-18T12:24:55.926840,0,820,1.0,10,3.4
2025-08-18T12:24:56.427173,0,820,1.0,10,2.9
2025-08-18T12:24:56.927495,0,820,1.0,10,3.6
2025-08-18T12:24:57.427849,0,820,1.0,10,3.5
2025-08-18T12:24:57.928364,0,820,1.0,10,3.2
2025-08-18T12:24:58.428672,0,820,1.0,10,3.5
2025-08-18T12:24:58.928914,0,820,1.0,10,3.4
2025-08-18T12:24:59.429432,0,820,1.0,10,3.0
2025-08-18T12:24:59.929768,0,820,1.0,10,3.4
2025-08-18T12:25:00.430111,0,820,1.0,10,3.6
2025-08-18T12:25:00.930743,0,820,1.0,10,3.3
2025-08-18T12:25:01.431047,0,820,1.0,10,3.9
2025-08-18T12:25:01.931287,0,820,1.0,10,3.7
2025-08-18T12:25:02.432055,0,820,1.0,10,2.8
2025-08-18T12:25:02.932368,0,820,1.0,10,3.6
2025-08-18T12:25:03.432693,0,820,1.0,10,3.8
2025-08-18T12:25:03.933477,0,820,1.0,10,3.1
2025-08-18T12:25:04.434169,0,820,1.0,10,4.1
2025-08-18T12:25:04.934558,0,820,1.0,10,3.7
2025-08-18T12:25:05.435414,0,820,1.0,10,3.3
2025-08-18T12:25:05.935906,0,820,1.0,10,3.3
2025-08-18T12:25:06.436257,0,820,1.0,10,3.6
2025-08-18T12:25:06.937033,0,820,1.0,10,3.3
2025-08-18T12:25:07.437438,0,820,1.0,10,3.2
2025-08-18T12:25:07.937733,0,820,1.0,10,3.6
2025-08-18T12:25:08.438490,0,820,1.0,10,3.2
2025-08-18T12:25:08.938942,0,820,1.0,10,3.7
2025-08-18T12:25:09.439303,0,820,1.0,10,4.0
2025-08-18T12:25:09.940063,0,820,1.0,10,3.3
2025-08-18T12:25:10.440380,0,820,1.0,10,3.5
2025-08-18T12:25:10.940701,0,820,1.0,10,3.8
2025-08-18T12:25:11.441456,0,820,1.0,10,2.8
2025-08-18T12:25:11.941913,0,820,1.0,10,3.5
2025-08-18T12:25:12.442165,0,820,1.0,10,3.5
2025-08-18T12:25:12.942684,0,820,1.0,10,3.4
2025-08-18T12:25:13.442988,0,820,1.0,10,3.8
2025-08-18T12:25:13.943272,0,820,1.0,10,3.6
2025-08-18T12:25:14.443529,0,820,1.0,10,3.6
2025-08-18T12:25:14.943803,0,820,1.0,10,3.9
2025-08-18T12:25:15.444300,0,820,1.0,10,3.6
2025-08-18T12:25:15.944601,0,820,1.0,10,3.2
2025-08-18T12:25:16.446034,0,820,1.0,10,3.4
2025-08-18T12:25:16.946599,0,820,1.0,10,3.7
2025-08-18T12:25:17.446908,0,820,1.0,10,3.6
2025-08-18T12:25:17.947133,0,820,1.0,10,3.8
2025-08-18T12:25:18.447661,0,820,1.0,10,3.1
2025-08-18T12:25:18.948012,0,820,1.0,10,3.7
2025-08-18T12:25:19.448287,0,820,1.0,10,3.9
2025-08-18T12:25:19.948644,0,820,1.0,10,3.5
2025-08-18T12:25:20.448951,0,820,1.0,10,3.8
2025-08-18T12:25:20.949545,0,820,1.0,10,3.6
2025-08-18T12:25:21.449896,0,820,1.0,10,3.4
2025-08-18T12:25:21.950165,0,820,1.0,10,3.7
2025-08-18T12:25:22.450704,0,820,1.0,10,3.2
2025-08-18T12:25:22.951072,0,820,1.0,10,3.7
2025-08-18T12:25:23.451375,0,820,1.0,10,3.8
2025-08-18T12:25:23.951639,0,820,1.0,10,3.2
2025-08-18T12:25:24.451922,0,820,1.0,10,3.8
2025-08-18T12:25:24.952473,0,820,1.0,10,3.3
2025-08-18T12:25:25.452806,0,820,1.0,10,3.4
2025-08-18T12:25:25.953050,0,820,1.0,10,3.7
2025-08-18T12:25:26.453575,0,820,1.0,10,2.9
2025-08-18T12:25:26.953987,0,820,1.0,10,3.9
2025-08-18T12:25:27.454325,0,820,1.0,10,3.7
2025-08-18T12:25:27.955134,0,820,1.0,10,3.4
2025-08-18T12:25:28.455619,0,820,1.0,10,3.8
2025-08-18T12:25:28.955930,0,820,1.0,10,3.5
2025-08-18T12:25:29.456800,0,820,1.0,10,3.1
2025-08-18T12:25:29.957219,0,820,1.0,10,3.6
2025-08-18T12:25:30.457606,0,820,1.0,10,3.6
2025-08-18T12:25:30.958392,0,820,1.0,10,3.3
2025-08-18T12:25:31.458875,0,820,1.0,10,3.5
2025-08-18T12:25:31.959210,0,820,1.0,10,3.7
2025-08-18T12:25:32.459570,0,820,1.0,10,3.1
2025-08-18T12:25:32.959890,0,820,1.0,10,3.6
2025-08-18T12:25:33.460679,0,820,1.0,10,3.4
2025-08-18T12:25:33.961121,0,820,1.0,10,3.6
2025-08-18T12:25:34.461474,0,820,1.0,10,3.5
2025-08-18T12:25:34.962215,0,820,1.0,10,3.4
2025-08-18T12:25:35.462665,0,820,1.0,10,3.4
2025-08-18T12:25:35.962969,0,820,1.0,10,3.6
2025-08-18T12:25:36.463919,0,820,1.0,10,3.3
2025-08-18T12:25:36.964352,0,820,1.0,10,3.2
2025-08-18T12:25:37.464695,0,820,1.0,10,3.5
2025-08-18T12:25:37.965560,0,820,1.0,10,3.4
2025-08-18T12:25:38.465979,0,820,1.0,10,3.5
2025-08-18T12:25:38.966289,0,820,1.0,10,3.7
2025-08-18T12:25:39.467135,0,820,1.0,10,3.4
2025-08-18T12:25:39.967575,0,820,1.0,10,3.3
2025-08-18T12:25:40.467848,0,820,1.0,10,3.4
2025-08-18T12:25:40.968385,0,820,1.0,10,3.6
2025-08-18T12:25:41.468678,0,820,1.0,10,3.8
2025-08-18T12:25:41.968925,0,820,1.0,10,3.9
2025-08-18T12:25:42.469489,0,820,1.0,10,3.3
2025-08-18T12:25:42.969839,0,820,1.0,10,3.4
2025-08-18T12:25:43.470091,0,820,1.0,10,3.4
2025-08-18T12:25:43.970557,0,820,1.0,10,3.3
2025-08-18T12:25:44.470856,0,820,1.0,10,3.1
2025-08-18T12:25:44.971108,0,820,1.0,10,3.6
2025-08-18T12:25:45.471744,0,820,1.0,10,3.6
2025-08-18T12:25:45.972072,0,820,1.0,10,3.7
2025-08-18T12:25:46.472320,0,820,1.0,10,3.4
2025-08-18T12:25:46.972927,0,820,1.0,10,3.2
2025-08-18T12:25:47.473237,0,820,1.0,10,3.6
2025-08-18T12:25:47.973484,0,820,1.0,10,3.5
2025-08-18T12:25:48.473983,0,820,1.0,10,3.1
2025-08-18T12:25:48.974292,0,820,1.0,10,3.9
2025-08-18T12:25:49.474590,0,820,1.0,10,4.1
2025-08-18T12:25:49.975129,0,820,1.0,10,3.5
2025-08-18T12:25:50.475463,0,820,1.0,10,3.8
2025-08-18T12:25:50.975680,0,820,1.0,10,3.5
2025-08-18T12:25:51.476212,0,820,1.0,10,3.1
2025-08-18T12:25:51.976591,0,820,1.0,10,4.8
2025-08-18T12:25:52.476913,0,820,1.0,10,3.4
2025-08-18T12:25:52.977174,0,820,1.0,10,3.3
2025-08-18T12:25:53.477417,0,820,1.0,10,3.8
2025-08-18T12:25:53.977941,0,820,1.0,10,3.2
2025-08-18T12:25:54.478257,0,820,1.0,10,3.6
2025-08-18T12:25:54.978576,0,820,1.0,10,3.3
2025-08-18T12:25:55.478836,0,820,1.0,10,3.0
2025-08-18T12:25:55.979075,0,820,1.0,10,3.5
2025-08-18T12:25:56.479587,0,820,1.0,10,3.3
2025-08-18T12:25:56.979894,0,820,1.0,10,3.3
2025-08-18T12:25:57.480137,0,820,1.0,10,3.4
2025-08-18T12:25:57.980659,0,820,1.0,10,3.2
2025-08-18T12:25:58.480969,0,820,1.0,10,3.3
2025-08-18T12:25:58.981241,0,820,1.0,10,3.3
2025-08-18T12:25:59.481754,0,820,1.0,10,3.2
2025-08-18T12:25:59.982056,0,820,1.0,10,5.4
2025-08-18T12:26:00.482332,0,820,1.0,10,5.3
2025-08-18T12:26:00.982670,0,820,1.0,10,5.2
2025-08-18T12:26:01.482926,0,820,1.0,10,5.6
2025-08-18T12:26:01.983185,0,820,1.0,10,3.8
2025-08-18T12:26:02.483611,0,820,1.0,10,4.9
2025-08-18T12:26:02.983886,0,820,1.0,10,5.3
2025-08-18T12:26:03.484381,0,820,1.0,10,3.5
2025-08-18T12:26:03.984673,0,820,1.0,10,4.6
2025-08-18T12:26:04.484948,0,820,1.0,10,4.6
2025-08-18T12:26:04.985606,0,820,1.0,10,5.2
2025-08-18T12:26:05.485996,0,820,1.0,10,4.3
2025-08-18T12:26:05.986298,0,820,1.0,10,4.9
2025-08-18T12:26:06.486595,0,820,1.0,10,5.1
2025-08-18T12:26:06.986842,0,820,1.0,10,4.6
2025-08-18T12:26:07.487349,0,820,1.0,10,3.3
2025-08-18T12:26:07.987645,0,820,1.0,10,3.6
2025-08-18T12:26:08.487904,0,820,1.0,10,3.7
2025-08-18T12:26:08.988163,0,820,1.0,10,4.3
2025-08-18T12:26:09.488413,0,820,1.0,10,5.1
2025-08-18T12:26:09.988637,0,820,1.0,10,4.3
2025-08-18T12:26:10.488936,0,820,1.0,10,3.4
2025-08-18T12:26:10.989232,0,820,1.0,10,3.7
2025-08-18T12:26:11.489546,0,820,1.0,10,5.3
2025-08-18T12:26:11.990067,0,820,1.0,10,3.4
2025-08-18T12:26:12.490323,0,820,1.0,10,3.5
2025-08-18T12:26:12.990573,0,820,1.0,10,3.6
2025-08-18T12:26:13.491173,0,820,1.0,10,3.3
2025-08-18T12:26:13.991459,0,820,1.0,10,3.7
2025-08-18T12:26:14.491925,0,820,1.0,10,3.8
2025-08-18T12:26:14.992268,0,820,1.0,10,3.8
2025-08-18T12:26:15.492598,0,820,1.0,10,3.8
2025-08-18T12:26:15.992929,0,820,1.0,10,3.6
2025-08-18T12:26:16.493220,0,820,1.0,10,3.3
2025-08-18T12:26:16.993483,0,820,1.0,10,3.5
2025-08-18T12:26:17.493971,0,820,1.0,10,3.3
2025-08-18T12:26:17.994299,0,820,1.0,10,3.4
2025-08-18T12:26:18.494586,0,820,1.0,10,3.3
2025-08-18T12:26:18.995101,0,820,1.0,10,3.2
2025-08-18T12:26:19.495531,0,820,1.0,10,3.6
2025-08-18T12:26:19.995781,0,820,1.0,10,3.7
2025-08-18T12:26:20.496024,0,820,1.0,10,4.3
2025-08-18T12:26:20.996321,0,820,1.0,10,4.6
2025-08-18T12:26:21.496570,0,820,1.0,10,3.6
2025-08-18T12:26:21.997074,0,820,1.0,10,4.4
2025-08-18T12:26:22.497380,0,820,1.0,10,4.4
2025-08-18T12:26:22.997635,0,820,1.0,10,3.9
2025-08-18T12:26:23.498046,0,820,1.0,10,3.3
2025-08-18T12:26:23.998334,0,820,1.0,10,3.3
2025-08-18T12:26:24.498641,0,820,1.0,10,4.9
2025-08-18T12:26:24.998954,0,820,1.0,10,4.3
2025-08-18T12:26:25.499230,0,820,1.0,10,3.3
2025-08-18T12:26:25.999562,0,820,1.0,10,4.0
2025-08-18T12:26:26.499907,0,820,1.0,10,3.5
2025-08-18T12:26:27.000236,0,820,1.0,10,3.5
2025-08-18T12:26:27.500543,0,820,1.0,10,5.2
2025-08-18T12:26:28.000766,0,820,1.0,10,3.6
2025-08-18T12:26:28.501090,0,820,1.0,10,3.0
2025-08-18T12:26:29.001329,0,820,1.0,10,3.6
2025-08-18T12:26:29.501908,0,820,1.0,10,3.4
2025-08-18T12:26:30.002226,0,820,1.0,10,3.2
2025-08-18T12:26:30.502505,0,820,1.0,10,3.4
2025-08-18T12:26:31.003024,0,820,1.0,10,3.2
2025-08-18T12:26:31.503352,0,820,1.0,10,3.3
2025-08-18T12:26:32.003663,0,820,1.0,10,3.6
2025-08-18T12:26:32.504243,0,820,1.0,10,3.6
2025-08-18T12:26:33.004639,0,820,1.0,10,3.6
2025-08-18T12:26:33.504877,0,820,1.0,10,3.5
2025-08-18T12:26:34.005370,0,820,1.0,10,3.1
2025-08-18T12:26:34.505688,0,820,1.0,10,3.9
2025-08-18T12:26:35.005900,0,820,1.0,10,3.6
2025-08-18T12:26:35.506372,0,820,1.0,10,2.9
2025-08-18T12:26:36.006705,0,820,1.0,10,3.5
2025-08-18T12:26:36.506937,0,820,1.0,10,3.6
2025-08-18T12:26:37.007549,0,820,1.0,10,3.1
2025-08-18T12:26:37.507856,0,820,1.0,10,3.6
2025-08-18T12:26:38.008182,0,820,1.0,10,3.4
2025-08-18T12:26:38.508479,0,820,1.0,10,2.9
2025-08-18T12:26:39.008716,0,820,1.0,10,3.7
2025-08-18T12:26:39.509217,0,820,1.0,10,3.4
2025-08-18T12:26:40.009591,0,820,1.0,10,3.1
2025-08-18T12:26:40.509931,0,820,1.0,10,3.4
2025-08-18T12:26:41.010440,0,820,1.0,10,3.2
2025-08-18T12:26:41.510754,0,820,1.0,10,3.4
2025-08-18T12:26:42.011013,0,820,1.0,10,3.6
2025-08-18T12:26:42.511570,0,820,1.0,10,3.0
2025-08-18T12:26:43.011890,0,820,1.0,10,3.4
2025-08-18T12:26:43.512119,0,820,1.0,10,3.6
2025-08-18T12:26:44.012611,0,820,1.0,10,3.4
2025-08-18T12:26:44.512914,0,820,1.0,10,3.5
2025-08-18T12:26:45.013146,0,820,1.0,10,3.6
2025-08-18T12:26:45.513663,0,820,1.0,10,3.6
2025-08-18T12:26:46.013951,0,820,1.0,10,3.3
2025-08-18T12:26:46.514243,0,820,1.0,10,3.6
2025-08-18T12:26:47.014862,0,820,1.0,10,3.0
2025-08-18T12:26:47.515161,0,820,1.0,10,5.6
2025-08-18T12:26:48.015409,0,820,1.0,10,5.3
2025-08-18T12:26:48.515823,0,820,1.0,10,5.2
2025-08-18T12:26:49.016133,0,820,1.0,10,5.6
2025-08-18T12:26:49.516590,0,820,1.0,10,5.1
2025-08-18T12:26:50.017125,0,820,1.0,10,5.1
2025-08-18T12:26:50.517435,0,820,1.0,10,3.8
2025-08-18T12:26:51.017646,0,820,1.0,10,3.6
2025-08-18T12:26:51.518259,0,820,1.0,10,3.5
2025-08-18T12:26:52.018595,0,820,1.0,10,3.5
2025-08-18T12:26:52.518855,0,820,1.0,10,3.5
2025-08-18T12:26:53.019090,0,820,1.0,10,3.3
2025-08-18T12:26:53.519332,0,820,1.0,10,5.4
2025-08-18T12:26:54.019580,0,820,1.0,10,4.3
2025-08-18T12:26:54.520092,0,820,1.0,10,3.4
2025-08-18T12:26:55.020369,0,820,1.0,10,3.7
2025-08-18T12:26:55.520618,0,820,1.0,10,4.3
2025-08-18T12:26:56.021225,0,820,1.0,10,4.9
2025-08-18T12:26:56.521559,0,820,1.0,10,5.4
2025-08-18T12:26:57.021788,0,820,1.0,10,3.9
2025-08-18T12:26:57.522027,0,820,1.0,10,3.1
2025-08-18T12:26:58.022259,0,820,1.0,10,4.5
2025-08-18T12:26:58.522749,0,820,1.0,10,3.6
2025-08-18T12:26:59.023031,0,820,1.0,10,3.4
2025-08-18T12:26:59.523278,0,820,1.0,10,3.6
2025-08-18T12:27:00.023535,0,820,1.0,10,3.5
2025-08-18T12:27:00.523761,0,820,1.0,10,3.1
2025-08-18T12:27:01.024006,0,820,1.0,10,3.6
2025-08-18T12:27:01.524239,0,820,1.0,10,5.1
2025-08-18T12:27:02.024458,0,820,1.0,10,5.6
2025-08-18T12:27:02.524727,0,820,1.0,10,4.9
2025-08-18T12:27:03.024977,0,820,1.0,10,3.6
2025-08-18T12:27:03.525228,0,820,1.0,10,3.9
2025-08-18T12:27:04.025465,0,820,1.0,10,3.6
2025-08-18T12:27:04.525706,0,820,1.0,10,3.6
2025-08-18T12:27:05.025950,0,820,1.0,10,3.8
2025-08-18T12:27:05.526236,0,820,1.0,10,3.4
2025-08-18T12:27:06.026573,0,820,1.0,10,3.9
2025-08-18T12:27:06.526869,0,820,1.0,10,6.5
2025-08-18T12:27:07.027114,0,820,1.0,10,5.1
2025-08-18T12:27:07.527364,0,820,1.0,10,4.6
2025-08-18T12:27:08.027887,0,820,1.0,10,3.4
2025-08-18T12:27:08.528205,0,820,1.0,10,4.1
2025-08-18T12:27:09.028504,0,820,1.0,10,3.8
2025-08-18T12:27:09.528923,0,820,1.0,10,3.4
2025-08-18T12:27:10.029202,0,820,1.0,10,4.0
2025-08-18T12:27:10.529537,0,820,1.0,10,4.8
2025-08-18T12:27:11.029994,0,820,1.0,10,3.3
2025-08-18T12:27:11.530313,0,820,1.0,10,4.0
2025-08-18T12:27:12.030625,0,820,1.0,10,3.5
2025-08-18T12:27:12.531205,0,820,1.0,10,3.6
2025-08-18T12:27:13.031548,0,820,1.0,10,3.7
2025-08-18T12:27:13.531803,0,820,1.0,10,3.9
2025-08-18T12:27:14.032026,0,820,1.0,10,5.2
2025-08-18T12:27:14.532261,0,820,1.0,10,4.2
2025-08-18T12:27:15.032514,0,820,1.0,10,3.8
2025-08-18T12:27:15.532850,0,820,1.0,10,3.0
2025-08-18T12:27:16.033070,0,820,1.0,10,3.5
2025-08-18T12:27:16.533588,0,820,1.0,10,3.1
2025-08-18T12:27:17.033909,0,820,1.0,10,3.3
2025-08-18T12:27:17.534155,0,820,1.0,10,3.6
2025-08-18T12:27:18.034801,0,820,1.0,10,3.5
2025-08-18T12:27:18.535125,0,820,1.0,10,3.9
2025-08-18T12:27:19.035347,0,820,1.0,10,3.9
2025-08-18T12:27:19.535854,0,820,1.0,10,3.4
2025-08-18T12:27:20.036128,0,820,1.0,10,3.9
2025-08-18T12:27:20.536530,0,820,1.0,10,3.7
2025-08-18T12:27:21.036808,0,820,1.0,10,3.3
2025-08-18T12:27:21.537232,0,820,1.0,10,3.4
2025-08-18T12:27:22.037789,0,820,1.0,10,3.6
2025-08-18T12:27:22.538102,0,820,1.0,10,3.6
2025-08-18T12:27:23.038324,0,820,1.0,10,3.9
2025-08-18T12:27:23.538560,0,820,1.0,10,3.7
2025-08-18T12:27:24.038875,0,820,1.0,10,3.4
2025-08-18T12:27:24.539174,0,820,1.0,10,3.6
2025-08-18T12:27:25.039535,0,820,1.0,10,3.9
2025-08-18T12:27:25.539848,0,820,1.0,10,3.1
2025-08-18T12:27:26.040140,0,820,1.0,10,3.6
2025-08-18T12:27:26.540609,0,820,1.0,10,3.6
2025-08-18T12:27:27.040870,0,820,1.0,10,3.3
2025-08-18T12:27:27.541112,0,820,1.0,10,3.6
2025-08-18T12:27:28.041628,0,820,1.0,10,3.3
2025-08-18T12:27:28.541946,0,820,1.0,10,3.4
2025-08-18T12:27:29.042162,0,820,1.0,10,3.6
2025-08-18T12:27:29.542775,0,820,1.0,10,3.5
2025-08-18T12:27:30.043119,0,820,1.0,10,3.7
2025-08-18T12:27:30.543388,0,820,1.0,10,3.7
2025-08-18T12:27:31.044002,0,820,1.0,10,3.5
2025-08-18T12:27:31.544384,0,820,1.0,10,3.7
2025-08-18T12:27:32.044691,0,820,1.0,10,3.6
2025-08-18T12:27:32.545241,0,820,1.0,10,3.6
2025-08-18T12:27:33.045568,0,820,1.0,10,3.1
2025-08-18T12:27:33.546111,0,820,1.0,10,3.6
2025-08-18T12:27:34.046417,0,820,1.0,10,3.3
2025-08-18T12:27:34.546741,0,820,1.0,10,3.4
2025-08-18T12:27:35.046986,0,820,1.0,10,3.6
2025-08-18T12:27:35.547433,0,820,1.0,10,3.6
2025-08-18T12:27:36.048036,0,820,1.0,10,3.6
2025-08-18T12:27:36.548340,0,820,1.0,10,3.6
2025-08-18T12:27:37.048617,0,820,1.0,10,3.6
2025-08-18T12:27:37.549120,0,820,1.0,10,2.9
2025-08-18T12:27:38.049424,0,820,1.0,10,3.6
2025-08-18T12:27:38.549704,0,820,1.0,10,3.7
2025-08-18T12:27:39.050247,0,820,1.0,10,3.2
2025-08-18T12:27:39.550544,0,820,1.0,10,3.6
2025-08-18T12:27:40.051024,0,820,1.0,10,3.4
2025-08-18T12:27:40.551340,0,820,1.0,10,3.5
2025-08-18T12:27:41.051612,0,820,1.0,10,3.8
2025-08-18T12:27:41.551855,0,820,1.0,10,3.6
2025-08-18T12:27:42.052096,0,820,1.0,10,3.4
2025-08-18T12:27:42.552360,0,820,1.0,10,3.6
2025-08-18T12:27:43.052870,0,820,1.0,10,3.4
2025-08-18T12:27:43.553166,0,820,1.0,10,3.5
2025-08-18T12:27:44.053443,0,820,1.0,10,3.7
2025-08-18T12:27:44.553969,0,820,1.0,10,3.3
2025-08-18T12:27:45.054310,0,820,1.0,10,3.6
2025-08-18T12:27:45.554586,0,820,1.0,10,3.9
2025-08-18T12:27:46.055189,0,820,1.0,10,3.6
2025-08-18T12:27:46.555496,0,820,1.0,10,3.7
2025-08-18T12:27:47.055758,0,820,1.0,10,3.6
2025-08-18T12:27:47.556055,0,820,1.0,10,3.5
2025-08-18T12:27:48.056952,0,820,1.0,10,3.1
2025-08-18T12:27:48.557322,0,820,1.0,10,3.5
2025-08-18T12:27:49.057600,0,820,1.0,10,3.5
2025-08-18T12:27:49.558127,0,820,1.0,10,3.1
2025-08-18T12:27:50.058466,0,820,1.0,10,3.8
2025-08-18T12:27:50.558733,0,820,1.0,10,3.4
2025-08-18T12:27:51.058985,0,820,1.0,10,3.2
2025-08-18T12:27:51.559271,0,820,1.0,10,3.6
2025-08-18T12:27:52.059889,0,820,1.0,10,3.3
2025-08-18T12:27:52.560203,0,820,1.0,10,3.3
2025-08-18T12:27:53.060479,0,820,1.0,10,3.6
2025-08-18T12:27:53.561043,0,820,1.0,10,3.2
2025-08-18T12:27:54.061396,0,820,1.0,10,3.3
2025-08-18T12:27:54.561650,0,820,1.0,10,3.6
2025-08-18T12:27:55.061975,0,820,1.0,10,3.4
2025-08-18T12:27:55.562262,0,820,1.0,10,3.2
2025-08-18T12:27:56.062520,0,820,1.0,10,3.6
2025-08-18T12:27:56.563054,0,820,1.0,10,3.4
2025-08-18T12:27:57.063372,0,820,1.0,10,3.3
2025-08-18T12:27:57.563625,0,820,1.0,10,3.4
2025-08-18T12:27:58.064165,0,820,1.0,10,3.1
2025-08-18T12:27:58.564471,0,820,1.0,10,3.4
2025-08-18T12:27:59.064725,0,820,1.0,10,3.6
2025-08-18T12:27:59.565254,0,820,1.0,10,3.0
2025-08-18T12:28:00.065585,0,820,1.0,10,3.7
2025-08-18T12:28:00.565831,0,820,1.0,10,4.8
2025-08-18T12:28:01.066580,0,820,1.0,10,3.3
2025-08-18T12:28:01.566962,0,820,1.0,10,5.0
2025-08-18T12:28:02.067202,0,820,1.0,10,4.9
2025-08-18T12:28:02.567735,0,820,1.0,10,3.6
2025-08-18T12:28:03.068071,0,820,1.0,10,3.9
2025-08-18T12:28:03.568361,0,820,1.0,10,3.7
2025-08-18T12:28:04.069028,0,820,1.0,10,3.7
2025-08-18T12:28:04.569390,0,820,1.0,10,3.7
2025-08-18T12:28:05.069647,0,820,1.0,10,5.6
2025-08-18T12:28:05.570129,0,820,1.0,10,3.7
2025-08-18T12:28:06.070726,0,820,1.0,10,3.8
2025-08-18T12:28:06.571036,0,820,1.0,10,4.4
2025-08-18T12:28:07.071258,0,820,1.0,10,3.6
2025-08-18T12:28:07.571810,0,820,1.0,10,3.3
2025-08-18T12:28:08.072139,0,820,1.0,10,3.3
2025-08-18T12:28:08.572519,0,820,1.0,10,3.6
2025-08-18T12:28:09.073101,0,820,1.0,10,3.4
2025-08-18T12:28:09.573446,0,820,1.0,10,3.6
2025-08-18T12:28:10.073700,0,820,1.0,10,3.4
2025-08-18T12:28:10.573933,0,820,1.0,10,2.8
2025-08-18T12:28:11.074208,0,820,1.0,10,3.6
2025-08-18T12:28:11.574782,0,820,1.0,10,3.4
2025-08-18T12:28:12.075083,0,820,1.0,10,3.3
2025-08-18T12:28:12.575353,0,820,1.0,10,3.6
2025-08-18T12:28:13.075934,0,820,1.0,10,3.3
2025-08-18T12:28:13.576256,0,820,1.0,10,3.6
2025-08-18T12:28:14.076516,0,820,1.0,10,3.6
2025-08-18T12:28:14.577018,0,820,1.0,10,3.1
2025-08-18T12:28:15.077325,0,820,1.0,10,3.6
2025-08-18T12:28:15.578831,0,820,1.0,10,3.8
2025-08-18T12:28:16.079070,0,820,1.0,10,3.3
2025-08-18T12:28:16.579317,0,820,1.0,10,3.4
2025-08-18T12:28:17.079609,0,820,1.0,10,3.4
2025-08-18T12:28:17.580085,0,820,1.0,10,2.9
2025-08-18T12:28:18.080407,0,820,1.0,10,3.6
2025-08-18T12:28:18.580685,0,820,1.0,10,3.7
2025-08-18T12:28:19.081229,0,820,1.0,10,3.5
2025-08-18T12:28:19.581537,0,820,1.0,10,3.6
2025-08-18T12:28:20.081788,0,820,1.0,10,3.6
2025-08-18T12:28:20.582551,0,820,1.0,10,3.0
2025-08-18T12:28:21.083020,0,820,1.0,10,3.7
2025-08-18T12:28:21.583492,0,820,1.0,10,3.6
2025-08-18T12:28:22.083855,0,820,1.0,10,3.5
2025-08-18T12:28:22.584128,0,820,1.0,10,3.7
2025-08-18T12:28:23.084587,0,820,1.0,10,3.6
2025-08-18T12:28:23.584851,0,820,1.0,10,3.3
2025-08-18T12:28:24.085128,0,820,1.0,10,3.6
2025-08-18T12:28:24.585384,0,820,1.0,10,3.6
2025-08-18T12:28:25.085870,0,820,1.0,10,3.6
2025-08-18T12:28:25.586164,0,820,1.0,10,3.8
2025-08-18T12:28:26.086601,0,820,1.0,10,3.5
2025-08-18T12:28:26.586977,0,820,1.0,10,3.0
2025-08-18T12:28:27.087247,0,820,1.0,10,3.5
2025-08-18T12:28:27.587538,0,820,1.0,10,3.6
2025-08-18T12:28:28.088098,0,820,1.0,10,3.3
2025-08-18T12:28:28.588400,0,820,1.0,10,3.6
2025-08-18T12:28:29.088644,0,820,1.0,10,3.6
2025-08-18T12:28:29.589250,0,820,1.0,10,3.3
2025-08-18T12:28:30.089619,0,820,1.0,10,3.6
2025-08-18T12:28:30.589867,0,820,1.0,10,3.4
2025-08-18T12:28:31.090314,0,820,1.0,10,3.4
2025-08-18T12:28:31.590636,0,820,1.0,10,3.2
2025-08-18T12:28:32.090894,0,820,1.0,10,3.4
2025-08-18T12:28:32.591460,0,820,1.0,10,3.5
2025-08-18T12:28:33.091797,0,820,1.0,10,3.5
2025-08-18T12:28:33.592079,0,820,1.0,10,3.6
2025-08-18T12:28:34.092669,0,820,1.0,10,3.6
2025-08-18T12:28:34.592985,0,820,1.0,10,3.3
2025-08-18T12:28:35.093242,0,820,1.0,10,3.6
2025-08-18T12:28:35.593795,0,820,1.0,10,3.1
2025-08-18T12:28:36.094090,0,820,1.0,10,3.3
2025-08-18T12:28:36.594335,0,820,1.0,10,3.7
2025-08-18T12:28:37.094925,0,820,1.0,10,3.3
2025-08-18T12:28:37.595188,0,820,1.0,10,3.5
2025-08-18T12:28:38.095434,0,820,1.0,10,3.5
2025-08-18T12:28:38.596014,0,820,1.0,10,3.6
2025-08-18T12:28:39.096327,0,820,1.0,10,3.5
2025-08-18T12:28:39.596604,0,820,1.0,10,3.7
2025-08-18T12:28:40.097207,0,820,1.0,10,3.3
2025-08-18T12:28:40.597569,0,820,1.0,10,3.4
2025-08-18T12:28:41.097791,0,820,1.0,10,3.6
2025-08-18T12:28:41.598301,0,820,1.0,10,3.1
2025-08-18T12:28:42.098666,0,820,1.0,10,3.8
2025-08-18T12:28:42.598939,0,820,1.0,10,5.0
2025-08-18T12:28:43.099624,0,820,1.0,10,4.8
2025-08-18T12:28:43.599956,0,820,1.0,10,4.6
2025-08-18T12:28:44.100223,0,820,1.0,10,5.6
2025-08-18T12:28:44.600816,0,820,1.0,10,4.9
2025-08-18T12:28:45.101099,0,820,1.0,10,9.8
2025-08-18T12:28:45.601305,0,820,1.0,10,6.8
2025-08-18T12:28:46.101957,0,820,1.0,10,4.8
2025-08-18T12:28:46.602279,0,820,1.0,10,4.3
2025-08-18T12:28:47.102565,0,820,1.0,10,4.3
2025-08-18T12:28:47.602841,0,820,1.0,10,4.6
2025-08-18T12:28:48.103088,0,820,1.0,10,5.2
2025-08-18T12:28:48.603333,0,820,1.0,10,4.3
2025-08-18T12:28:49.103619,0,820,1.0,10,4.1
2025-08-18T12:28:49.603859,0,820,1.0,10,4.4
2025-08-18T12:28:50.104317,0,820,1.0,10,4.4
2025-08-18T12:28:50.604856,0,820,1.0,10,3.9
2025-08-18T12:28:51.105144,0,820,1.0,10,3.5
2025-08-18T12:28:51.605373,0,820,1.0,10,4.3
2025-08-18T12:28:52.105629,0,820,1.0,10,5.8
2025-08-18T12:28:52.605878,0,820,1.0,10,4.9
2025-08-18T12:28:53.106131,0,820,1.0,10,3.7
2025-08-18T12:28:53.606370,0,820,1.0,10,4.2
2025-08-18T12:28:54.106960,0,820,1.0,10,3.5
2025-08-18T12:28:54.607321,0,820,1.0,10,3.7
2025-08-18T12:28:55.107624,0,820,1.0,10,3.6
2025-08-18T12:28:55.607873,0,820,1.0,10,3.6
2025-08-18T12:28:56.108155,0,820,1.0,10,4.5
2025-08-18T12:28:56.608438,0,820,1.0,10,4.8
2025-08-18T12:28:57.108738,0,820,1.0,10,4.5
2025-08-18T12:28:57.609041,0,820,1.0,10,5.2
2025-08-18T12:28:58.109286,0,820,1.0,10,5.5
2025-08-18T12:28:58.609811,0,820,1.0,10,4.9
2025-08-18T12:28:59.110111,0,820,1.0,10,4.8
2025-08-18T12:28:59.610350,0,820,1.0,10,4.4
2025-08-18T12:29:00.110813,0,820,1.0,10,4.8
2025-08-18T12:29:00.611097,0,820,1.0,10,4.4
2025-08-18T12:29:01.111335,0,820,1.0,10,5.6
2025-08-18T12:29:01.611817,0,820,1.0,10,5.4
2025-08-18T12:29:02.112122,0,820,1.0,10,6.2
2025-08-18T12:29:02.612364,0,820,1.0,10,4.3
2025-08-18T12:29:03.112965,0,820,1.0,10,4.0
2025-08-18T12:29:03.613338,0,820,1.0,10,3.8
2025-08-18T12:29:04.113595,0,820,1.0,10,5.7
2025-08-18T12:29:04.614061,0,820,1.0,10,5.8
2025-08-18T12:29:05.114356,0,820,1.0,10,4.6
2025-08-18T12:29:05.614679,0,820,1.0,10,3.5
2025-08-18T12:29:06.115233,0,820,1.0,10,3.6
2025-08-18T12:29:06.615579,0,820,1.0,10,5.1
2025-08-18T12:29:07.115826,0,820,1.0,10,5.5
2025-08-18T12:29:07.616221,0,820,1.0,10,5.9
2025-08-18T12:29:08.116515,0,820,1.0,10,5.8
2025-08-18T12:29:08.616761,0,820,1.0,10,5.1
2025-08-18T12:29:09.117123,0,820,1.0,10,4.1
2025-08-18T12:29:09.617424,0,820,1.0,10,4.6
2025-08-18T12:29:10.117739,0,820,1.0,10,4.4
2025-08-18T12:29:10.618040,0,820,1.0,10,3.9
2025-08-18T12:29:11.118453,0,820,1.0,10,4.6
2025-08-18T12:29:11.618734,0,820,1.0,10,5.0
2025-08-18T12:29:12.118995,0,820,1.0,10,5.0
2025-08-18T12:29:12.619497,0,820,1.0,10,4.3
2025-08-18T12:29:13.119843,0,820,1.0,10,4.2
2025-08-18T12:29:13.620084,0,820,1.0,10,4.1
2025-08-18T12:29:14.120343,0,820,1.0,10,6.0
2025-08-18T12:29:14.620618,0,820,1.0,10,5.2
2025-08-18T12:29:15.120847,0,820,1.0,10,4.2
2025-08-18T12:29:15.621341,0,820,1.0,10,3.4
2025-08-18T12:29:16.121647,0,820,1.0,10,3.9
2025-08-18T12:29:16.621895,0,820,1.0,10,3.7
2025-08-18T12:29:17.122275,0,820,1.0,10,4.3
2025-08-18T12:29:17.622504,0,820,1.0,10,4.4
2025-08-18T12:29:18.122743,0,820,1.0,10,4.3
2025-08-18T12:29:18.623215,0,820,1.0,10,3.2
2025-08-18T12:29:19.123587,0,820,1.0,10,3.7
2025-08-18T12:29:19.623827,0,820,1.0,10,3.6
2025-08-18T12:29:20.124389,0,820,1.0,10,3.3
2025-08-18T12:29:20.624673,0,820,1.0,10,3.7
2025-08-18T12:29:21.124920,0,820,1.0,10,3.9
2025-08-18T12:29:21.625405,0,820,1.0,10,3.1
2025-08-18T12:29:22.125706,0,820,1.0,10,3.9
2025-08-18T12:29:22.626015,0,820,1.0,10,3.9
2025-08-18T12:29:23.126275,0,820,1.0,10,3.6
2025-08-18T12:29:23.626551,0,820,1.0,10,6.0
2025-08-18T12:29:24.126909,0,820,1.0,10,4.3
2025-08-18T12:29:24.627413,0,820,1.0,10,3.8
2025-08-18T12:29:25.127685,0,820,1.0,10,5.4
2025-08-18T12:29:25.627947,0,820,1.0,10,4.4
2025-08-18T12:29:26.128255,0,820,1.0,10,5.2
2025-08-18T12:29:26.628515,0,820,1.0,10,4.4
2025-08-18T12:29:27.128749,0,820,1.0,10,5.1
2025-08-18T12:29:27.629253,0,820,1.0,10,4.6
2025-08-18T12:29:28.129558,0,820,1.0,10,4.1
2025-08-18T12:29:28.629803,0,820,1.0,10,4.1
2025-08-18T12:29:29.130058,0,820,1.0,10,4.6
2025-08-18T12:29:29.630291,0,820,1.0,10,3.6
2025-08-18T12:29:30.130549,0,820,1.0,10,3.3
2025-08-18T12:29:30.630824,0,820,1.0,10,3.1
2025-08-18T12:29:31.131132,0,820,1.0,10,3.9
2025-08-18T12:29:31.631659,0,820,1.0,10,3.4
2025-08-18T12:29:32.131974,0,820,1.0,10,5.0
2025-08-18T12:29:32.632342,0,820,1.0,10,3.6
2025-08-18T12:29:33.132860,0,820,1.0,10,3.5
2025-08-18T12:29:33.633159,0,820,1.0,10,3.5
2025-08-18T12:29:34.133421,0,820,1.0,10,3.8
2025-08-18T12:29:34.634096,0,820,1.0,10,3.6
2025-08-18T12:29:35.134447,0,820,1.0,10,3.6
2025-08-18T12:29:35.634756,0,820,1.0,10,3.6
2025-08-18T12:29:36.135304,0,820,1.0,10,3.3
2025-08-18T12:29:36.635604,0,820,1.0,10,3.6
2025-08-18T12:29:37.135827,0,820,1.0,10,3.8
2025-08-18T12:29:37.636388,0,820,1.0,10,3.5
2025-08-18T12:29:38.136660,0,820,1.0,10,4.5
2025-08-18T12:29:38.636904,0,820,1.0,10,4.5
